name,total_wins,total_losses,total_matches,win_rate,current_rank,surface_stats,recent_form,last_match_date
Tallon Griekspoor,33,30,63,0.5238095238095238,40,"{'Hard': {'wins': 21, 'matches': 40, 'win_rate': 0.525}, 'Clay': {'wins': 8, 'matches': 16, 'win_rate': 0.5}, 'Grass': {'wins': 4, 'matches': 7, 'win_rate': 0.5714285714285714}}",5,2024-11-24
Ajeet Rai,0,3,3,0.0,498,"{'Hard': {'wins': 0, 'matches': 3, 'win_rate': 0.0}, 'Clay': {'wins': 0, 'matches': 0, 'win_rate': 0.0}, 'Grass': {'wins': 0, 'matches': 0, 'win_rate': 0.0}}",0,2024-09-14
Boris Arias,1,0,1,1.0,999,"{'Hard': {'wins': 0, 'matches': 0, 'win_rate': 0.0}, 'Clay': {'wins': 1, 'matches': 1, 'win_rate': 1.0}, 'Grass': {'wins': 0, 'matches': 0, 'win_rate': 0.0}}",1,2024-02-03
Benjamin Hassan,4,4,8,0.5,245,"{'Hard': {'wins': 0, 'matches': 1, 'win_rate': 0.0}, 'Clay': {'wins': 4, 'matches': 7, 'win_rate': 0.5714285714285714}, 'Grass': {'wins': 0, 'matches': 0, 'win_rate': 0.0}}",4,2024-10-14
Henrique Rocha,3,2,5,0.6,159,"{'Hard': {'wins': 2, 'matches': 2, 'win_rate': 1.0}, 'Clay': {'wins': 1, 'matches': 3, 'win_rate': 0.3333333333333333}, 'Grass': {'wins': 0, 'matches': 0, 'win_rate': 0.0}}",3,2024-09-13
Jannik Sinner,74,7,81,0.9135802469135802,1,"{'Hard': {'wins': 54, 'matches': 57, 'win_rate': 0.9473684210526315}, 'Clay': {'wins': 11, 'matches': 14, 'win_rate': 0.7857142857142857}, 'Grass': {'wins': 9, 'matches': 10, 'win_rate': 0.9}}",10,2024-11-24
Taylor Fritz,53,23,76,0.6973684210526315,4,"{'Hard': {'wins': 28, 'matches': 42, 'win_rate': 0.6666666666666666}, 'Clay': {'wins': 15, 'matches': 22, 'win_rate': 0.6818181818181818}, 'Grass': {'wins': 10, 'matches': 12, 'win_rate': 0.8333333333333334}}",6,2024-11-21
Andrea Pellegrino,0,1,1,0.0,153,"{'Hard': {'wins': 0, 'matches': 0, 'win_rate': 0.0}, 'Clay': {'wins': 0, 'matches': 1, 'win_rate': 0.0}, 'Grass': {'wins': 0, 'matches': 0, 'win_rate': 0.0}}",0,2024-07-15
Rowland Phillips,0,2,2,0.0,999,"{'Hard': {'wins': 0, 'matches': 2, 'win_rate': 0.0}, 'Clay': {'wins': 0, 'matches': 0, 'win_rate': 0.0}, 'Grass': {'wins': 0, 'matches': 0, 'win_rate': 0.0}}",0,2024-02-03
Jordan Thompson,36,25,61,0.5901639344262295,28,"{'Hard': {'wins': 29, 'matches': 46, 'win_rate': 0.6304347826086957}, 'Clay': {'wins': 3, 'matches': 8, 'win_rate': 0.375}, 'Grass': {'wins': 4, 'matches': 7, 'win_rate': 0.5714285714285714}}",5,2024-10-28
Egor Gerasimov,0,1,1,0.0,304,"{'Hard': {'wins': 0, 'matches': 1, 'win_rate': 0.0}, 'Clay': {'wins': 0, 'matches': 0, 'win_rate': 0.0}, 'Grass': {'wins': 0, 'matches': 0, 'win_rate': 0.0}}",0,2024-10-02
Ethan Quinn,1,3,4,0.25,254,"{'Hard': {'wins': 0, 'matches': 2, 'win_rate': 0.0}, 'Clay': {'wins': 0, 'matches': 0, 'win_rate': 0.0}, 'Grass': {'wins': 1, 'matches': 2, 'win_rate': 0.5}}",1,2024-07-15
Marc Polmans,0,2,2,0.0,217,"{'Hard': {'wins': 0, 'matches': 1, 'win_rate': 0.0}, 'Clay': {'wins': 0, 'matches': 0, 'win_rate': 0.0}, 'Grass': {'wins': 0, 'matches': 1, 'win_rate': 0.0}}",0,2024-07-15
Fitriadi M Rifqi,2,0,2,1.0,569,"{'Hard': {'wins': 2, 'matches': 2, 'win_rate': 1.0}, 'Clay': {'wins': 0, 'matches': 0, 'win_rate': 0.0}, 'Grass': {'wins': 0, 'matches': 0, 'win_rate': 0.0}}",2,2024-02-03
Juan Pablo Varillas,2,10,12,0.16666666666666666,179,"{'Hard': {'wins': 0, 'matches': 4, 'win_rate': 0.0}, 'Clay': {'wins': 2, 'matches': 8, 'win_rate': 0.25}, 'Grass': {'wins': 0, 'matches': 0, 'win_rate': 0.0}}",2,2024-09-13
Andrea Collarini,0,1,1,0.0,264,"{'Hard': {'wins': 0, 'matches': 0, 'win_rate': 0.0}, 'Clay': {'wins': 0, 'matches': 1, 'win_rate': 0.0}, 'Grass': {'wins': 0, 'matches': 0, 'win_rate': 0.0}}",0,2024-07-22
Zachary Svajda,4,9,13,0.3076923076923077,131,"{'Hard': {'wins': 4, 'matches': 12, 'win_rate': 0.3333333333333333}, 'Clay': {'wins': 0, 'matches': 0, 'win_rate': 0.0}, 'Grass': {'wins': 0, 'matches': 1, 'win_rate': 0.0}}",3,2024-10-02
Guido Andreozzi,0,1,1,0.0,406,"{'Hard': {'wins': 0, 'matches': 0, 'win_rate': 0.0}, 'Clay': {'wins': 0, 'matches': 1, 'win_rate': 0.0}, 'Grass': {'wins': 0, 'matches': 0, 'win_rate': 0.0}}",0,2024-07-22
Sebastian Dominko,1,1,2,0.5,1107,"{'Hard': {'wins': 1, 'matches': 2, 'win_rate': 0.5}, 'Clay': {'wins': 0, 'matches': 0, 'win_rate': 0.0}, 'Grass': {'wins': 0, 'matches': 0, 'win_rate': 0.0}}",1,2024-02-02
Omni Kumar,0,1,1,0.0,433,"{'Hard': {'wins': 0, 'matches': 1, 'win_rate': 0.0}, 'Clay': {'wins': 0, 'matches': 0, 'win_rate': 0.0}, 'Grass': {'wins': 0, 'matches': 0, 'win_rate': 0.0}}",0,2024-08-19
Max Purcell,14,20,34,0.4117647058823529,97,"{'Hard': {'wins': 8, 'matches': 21, 'win_rate': 0.38095238095238093}, 'Clay': {'wins': 2, 'matches': 5, 'win_rate': 0.4}, 'Grass': {'wins': 4, 'matches': 8, 'win_rate': 0.5}}",5,2024-08-26
Thiago Monteiro,13,13,26,0.5,100,"{'Hard': {'wins': 3, 'matches': 8, 'win_rate': 0.375}, 'Clay': {'wins': 10, 'matches': 17, 'win_rate': 0.5882352941176471}, 'Grass': {'wins': 0, 'matches': 1, 'win_rate': 0.0}}",2,2024-11-04
Kris Van Wyk,1,1,2,0.5,416,"{'Hard': {'wins': 1, 'matches': 2, 'win_rate': 0.5}, 'Clay': {'wins': 0, 'matches': 0, 'win_rate': 0.0}, 'Grass': {'wins': 0, 'matches': 0, 'win_rate': 0.0}}",1,2024-02-02
Karen Khachanov,37,22,59,0.6271186440677966,21,"{'Hard': {'wins': 28, 'matches': 43, 'win_rate': 0.6511627906976745}, 'Clay': {'wins': 8, 'matches': 12, 'win_rate': 0.6666666666666666}, 'Grass': {'wins': 1, 'matches': 4, 'win_rate': 0.25}}",8,2024-10-28
Nam Hoang Ly,2,0,2,1.0,554,"{'Hard': {'wins': 2, 'matches': 2, 'win_rate': 1.0}, 'Clay': {'wins': 0, 'matches': 0, 'win_rate': 0.0}, 'Grass': {'wins': 0, 'matches': 0, 'win_rate': 0.0}}",2,2024-02-02
Ignacio Buse,1,2,3,0.3333333333333333,212,"{'Hard': {'wins': 1, 'matches': 3, 'win_rate': 0.3333333333333333}, 'Clay': {'wins': 0, 'matches': 0, 'win_rate': 0.0}, 'Grass': {'wins': 0, 'matches': 0, 'win_rate': 0.0}}",1,2024-09-13
Roman Safiullin,18,25,43,0.4186046511627907,60,"{'Hard': {'wins': 13, 'matches': 28, 'win_rate': 0.4642857142857143}, 'Clay': {'wins': 3, 'matches': 10, 'win_rate': 0.3}, 'Grass': {'wins': 2, 'matches': 5, 'win_rate': 0.4}}",5,2024-11-04
Jerome Kym,1,1,2,0.5,140,"{'Hard': {'wins': 1, 'matches': 2, 'win_rate': 0.5}, 'Clay': {'wins': 0, 'matches': 0, 'win_rate': 0.0}, 'Grass': {'wins': 0, 'matches': 0, 'win_rate': 0.0}}",1,2024-10-21
Demetris Azoides,1,0,1,1.0,1054,"{'Hard': {'wins': 1, 'matches': 1, 'win_rate': 1.0}, 'Clay': {'wins': 0, 'matches': 0, 'win_rate': 0.0}, 'Grass': {'wins': 0, 'matches': 0, 'win_rate': 0.0}}",1,2024-09-14
Cem Ilkel,0,3,3,0.0,474,"{'Hard': {'wins': 0, 'matches': 1, 'win_rate': 0.0}, 'Clay': {'wins': 0, 'matches': 2, 'win_rate': 0.0}, 'Grass': {'wins': 0, 'matches': 0, 'win_rate': 0.0}}",0,2024-09-13
Beibit Zhukayev,3,2,5,0.6,213,"{'Hard': {'wins': 3, 'matches': 5, 'win_rate': 0.6}, 'Clay': {'wins': 0, 'matches': 0, 'win_rate': 0.0}, 'Grass': {'wins': 0, 'matches': 0, 'win_rate': 0.0}}",3,2024-10-14
Felipe Meligeni Alves,1,4,5,0.2,144,"{'Hard': {'wins': 0, 'matches': 0, 'win_rate': 0.0}, 'Clay': {'wins': 1, 'matches': 4, 'win_rate': 0.25}, 'Grass': {'wins': 0, 'matches': 1, 'win_rate': 0.0}}",1,2024-07-15
Zsombor Piros,3,0,3,1.0,222,"{'Hard': {'wins': 1, 'matches': 1, 'win_rate': 1.0}, 'Clay': {'wins': 2, 'matches': 2, 'win_rate': 1.0}, 'Grass': {'wins': 0, 'matches': 0, 'win_rate': 0.0}}",3,2024-09-13
Gabriel Diallo,8,8,16,0.5,86,"{'Hard': {'wins': 8, 'matches': 14, 'win_rate': 0.5714285714285714}, 'Clay': {'wins': 0, 'matches': 1, 'win_rate': 0.0}, 'Grass': {'wins': 0, 'matches': 1, 'win_rate': 0.0}}",6,2024-11-20
Sebastian Korda,32,19,51,0.6274509803921569,16,"{'Hard': {'wins': 20, 'matches': 31, 'win_rate': 0.6451612903225806}, 'Clay': {'wins': 5, 'matches': 10, 'win_rate': 0.5}, 'Grass': {'wins': 7, 'matches': 10, 'win_rate': 0.7}}",7,2024-08-26
Miomir Kecmanovic,25,30,55,0.45454545454545453,53,"{'Hard': {'wins': 15, 'matches': 34, 'win_rate': 0.4411764705882353}, 'Clay': {'wins': 6, 'matches': 13, 'win_rate': 0.46153846153846156}, 'Grass': {'wins': 4, 'matches': 8, 'win_rate': 0.5}}",5,2024-11-04
Vilius Gaubas,1,3,4,0.25,182,"{'Hard': {'wins': 1, 'matches': 4, 'win_rate': 0.25}, 'Clay': {'wins': 0, 'matches': 0, 'win_rate': 0.0}, 'Grass': {'wins': 0, 'matches': 0, 'win_rate': 0.0}}",1,2024-09-13
Giulio Zeppieri,2,5,7,0.2857142857142857,148,"{'Hard': {'wins': 1, 'matches': 4, 'win_rate': 0.25}, 'Clay': {'wins': 1, 'matches': 3, 'win_rate': 0.3333333333333333}, 'Grass': {'wins': 0, 'matches': 0, 'win_rate': 0.0}}",2,2024-05-27
Juan Carlos Fuentes Vasquez,1,1,2,0.5,999,"{'Hard': {'wins': 1, 'matches': 1, 'win_rate': 1.0}, 'Clay': {'wins': 0, 'matches': 1, 'win_rate': 0.0}, 'Grass': {'wins': 0, 'matches': 0, 'win_rate': 0.0}}",1,2024-09-14
Maxime Cressy,1,4,5,0.2,173,"{'Hard': {'wins': 0, 'matches': 3, 'win_rate': 0.0}, 'Clay': {'wins': 0, 'matches': 0, 'win_rate': 0.0}, 'Grass': {'wins': 1, 'matches': 2, 'win_rate': 0.5}}",1,2024-07-29
Daniil Medvedev,46,21,67,0.6865671641791045,4,"{'Hard': {'wins': 29, 'matches': 43, 'win_rate': 0.6744186046511628}, 'Clay': {'wins': 11, 'matches': 16, 'win_rate': 0.6875}, 'Grass': {'wins': 6, 'matches': 8, 'win_rate': 0.75}}",6,2024-11-11
Thanasi Kokkinakis,14,16,30,0.4666666666666667,77,"{'Hard': {'wins': 11, 'matches': 22, 'win_rate': 0.5}, 'Clay': {'wins': 2, 'matches': 6, 'win_rate': 0.3333333333333333}, 'Grass': {'wins': 1, 'matches': 2, 'win_rate': 0.5}}",6,2024-11-23
Alan Fernando Rubio Fierros,1,1,2,0.5,707,"{'Hard': {'wins': 1, 'matches': 2, 'win_rate': 0.5}, 'Clay': {'wins': 0, 'matches': 0, 'win_rate': 0.0}, 'Grass': {'wins': 0, 'matches': 0, 'win_rate': 0.0}}",1,2024-09-14
Elmer Moller,2,0,2,1.0,247,"{'Hard': {'wins': 1, 'matches': 1, 'win_rate': 1.0}, 'Clay': {'wins': 1, 'matches': 1, 'win_rate': 1.0}, 'Grass': {'wins': 0, 'matches': 0, 'win_rate': 0.0}}",2,2024-09-14
Hady Habib,1,2,3,0.3333333333333333,268,"{'Hard': {'wins': 0, 'matches': 0, 'win_rate': 0.0}, 'Clay': {'wins': 1, 'matches': 3, 'win_rate': 0.3333333333333333}, 'Grass': {'wins': 0, 'matches': 0, 'win_rate': 0.0}}",1,2024-09-14
Benjamin Balleret,1,1,2,0.5,999,"{'Hard': {'wins': 0, 'matches': 0, 'win_rate': 0.0}, 'Clay': {'wins': 1, 'matches': 2, 'win_rate': 0.5}, 'Grass': {'wins': 0, 'matches': 0, 'win_rate': 0.0}}",1,2024-09-14
Joris De Loore,0,1,1,0.0,192,"{'Hard': {'wins': 0, 'matches': 1, 'win_rate': 0.0}, 'Clay': {'wins': 0, 'matches': 0, 'win_rate': 0.0}, 'Grass': {'wins': 0, 'matches': 0, 'win_rate': 0.0}}",0,2024-02-03
Jakub Mensik,25,20,45,0.5555555555555556,48,"{'Hard': {'wins': 17, 'matches': 29, 'win_rate': 0.5862068965517241}, 'Clay': {'wins': 6, 'matches': 10, 'win_rate': 0.6}, 'Grass': {'wins': 2, 'matches': 6, 'win_rate': 0.3333333333333333}}",5,2024-12-18
Kamil Majchrzak,1,1,2,0.5,163,"{'Hard': {'wins': 1, 'matches': 2, 'win_rate': 0.5}, 'Clay': {'wins': 0, 'matches': 0, 'win_rate': 0.0}, 'Grass': {'wins': 0, 'matches': 0, 'win_rate': 0.0}}",1,2024-09-13
Benjamin Bonzi,5,6,11,0.45454545454545453,124,"{'Hard': {'wins': 5, 'matches': 10, 'win_rate': 0.5}, 'Clay': {'wins': 0, 'matches': 1, 'win_rate': 0.0}, 'Grass': {'wins': 0, 'matches': 0, 'win_rate': 0.0}}",5,2024-11-04
Remy Bertola,1,0,1,1.0,286,"{'Hard': {'wins': 1, 'matches': 1, 'win_rate': 1.0}, 'Clay': {'wins': 0, 'matches': 0, 'win_rate': 0.0}, 'Grass': {'wins': 0, 'matches': 0, 'win_rate': 0.0}}",1,2024-09-13
Francisco Cabral,0,1,1,0.0,999,"{'Hard': {'wins': 0, 'matches': 0, 'win_rate': 0.0}, 'Clay': {'wins': 0, 'matches': 1, 'win_rate': 0.0}, 'Grass': {'wins': 0, 'matches': 0, 'win_rate': 0.0}}",0,2024-07-29
Philip Hjorth,0,1,1,0.0,880,"{'Hard': {'wins': 0, 'matches': 1, 'win_rate': 0.0}, 'Clay': {'wins': 0, 'matches': 0, 'win_rate': 0.0}, 'Grass': {'wins': 0, 'matches': 0, 'win_rate': 0.0}}",0,2024-09-14
Aleksandre Bakshi,2,0,2,1.0,512,"{'Hard': {'wins': 2, 'matches': 2, 'win_rate': 1.0}, 'Clay': {'wins': 0, 'matches': 0, 'win_rate': 0.0}, 'Grass': {'wins': 0, 'matches': 0, 'win_rate': 0.0}}",2,2024-09-14
Maximus Jones,0,1,1,0.0,581,"{'Hard': {'wins': 0, 'matches': 0, 'win_rate': 0.0}, 'Clay': {'wins': 0, 'matches': 1, 'win_rate': 0.0}, 'Grass': {'wins': 0, 'matches': 0, 'win_rate': 0.0}}",0,2024-02-03
Andrea Vavassori,4,5,9,0.4444444444444444,206,"{'Hard': {'wins': 1, 'matches': 2, 'win_rate': 0.5}, 'Clay': {'wins': 3, 'matches': 7, 'win_rate': 0.42857142857142855}, 'Grass': {'wins': 0, 'matches': 0, 'win_rate': 0.0}}",4,2024-07-29
Luciano Darderi,25,26,51,0.49019607843137253,43,"{'Hard': {'wins': 2, 'matches': 14, 'win_rate': 0.14285714285714285}, 'Clay': {'wins': 21, 'matches': 32, 'win_rate': 0.65625}, 'Grass': {'wins': 2, 'matches': 5, 'win_rate': 0.4}}",1,2024-11-04
Frances Tiafoe,33,26,59,0.559322033898305,17,"{'Hard': {'wins': 25, 'matches': 43, 'win_rate': 0.5813953488372093}, 'Clay': {'wins': 5, 'matches': 10, 'win_rate': 0.5}, 'Grass': {'wins': 3, 'matches': 6, 'win_rate': 0.5}}",4,2024-10-28
Viacheslav Bielinskyi,0,1,1,0.0,498,"{'Hard': {'wins': 0, 'matches': 1, 'win_rate': 0.0}, 'Clay': {'wins': 0, 'matches': 0, 'win_rate': 0.0}, 'Grass': {'wins': 0, 'matches': 0, 'win_rate': 0.0}}",0,2024-02-01
Grigor Dimitrov,46,18,64,0.71875,9,"{'Hard': {'wins': 34, 'matches': 46, 'win_rate': 0.7391304347826086}, 'Clay': {'wins': 8, 'matches': 12, 'win_rate': 0.6666666666666666}, 'Grass': {'wins': 4, 'matches': 6, 'win_rate': 0.6666666666666666}}",7,2024-10-28
Arthur Cazaux,10,13,23,0.43478260869565216,85,"{'Hard': {'wins': 9, 'matches': 18, 'win_rate': 0.5}, 'Clay': {'wins': 0, 'matches': 2, 'win_rate': 0.0}, 'Grass': {'wins': 1, 'matches': 3, 'win_rate': 0.3333333333333333}}",4,2024-10-28
Michael Bassem Sobhy,0,1,1,0.0,1090,"{'Hard': {'wins': 0, 'matches': 0, 'win_rate': 0.0}, 'Clay': {'wins': 0, 'matches': 1, 'win_rate': 0.0}, 'Grass': {'wins': 0, 'matches': 0, 'win_rate': 0.0}}",0,2024-02-02
Zura Tkemaladze,0,2,2,0.0,721,"{'Hard': {'wins': 0, 'matches': 2, 'win_rate': 0.0}, 'Clay': {'wins': 0, 'matches': 0, 'win_rate': 0.0}, 'Grass': {'wins': 0, 'matches': 0, 'win_rate': 0.0}}",0,2024-02-03
Seong Chan Hong,3,4,7,0.42857142857142855,141,"{'Hard': {'wins': 3, 'matches': 7, 'win_rate': 0.42857142857142855}, 'Clay': {'wins': 0, 'matches': 0, 'win_rate': 0.0}, 'Grass': {'wins': 0, 'matches': 0, 'win_rate': 0.0}}",3,2024-09-13
Hugo Nys,1,0,1,1.0,999,"{'Hard': {'wins': 0, 'matches': 0, 'win_rate': 0.0}, 'Clay': {'wins': 1, 'matches': 1, 'win_rate': 1.0}, 'Grass': {'wins': 0, 'matches': 0, 'win_rate': 0.0}}",1,2024-09-14
Aleksandar Kovacevic,10,22,32,0.3125,101,"{'Hard': {'wins': 7, 'matches': 22, 'win_rate': 0.3181818181818182}, 'Clay': {'wins': 1, 'matches': 6, 'win_rate': 0.16666666666666666}, 'Grass': {'wins': 2, 'matches': 4, 'win_rate': 0.5}}",3,2024-11-04
Jan Choinski,1,3,4,0.25,276,"{'Hard': {'wins': 0, 'matches': 1, 'win_rate': 0.0}, 'Clay': {'wins': 1, 'matches': 2, 'win_rate': 0.5}, 'Grass': {'wins': 0, 'matches': 1, 'win_rate': 0.0}}",1,2024-08-26
Philip Henning,1,3,4,0.25,360,"{'Hard': {'wins': 1, 'matches': 2, 'win_rate': 0.5}, 'Clay': {'wins': 0, 'matches': 2, 'win_rate': 0.0}, 'Grass': {'wins': 0, 'matches': 0, 'win_rate': 0.0}}",1,2024-09-14
Gregoire Barrere,4,8,12,0.3333333333333333,166,"{'Hard': {'wins': 1, 'matches': 5, 'win_rate': 0.2}, 'Clay': {'wins': 3, 'matches': 7, 'win_rate': 0.42857142857142855}, 'Grass': {'wins': 0, 'matches': 0, 'win_rate': 0.0}}",4,2024-11-04
Charles Broom,0,2,2,0.0,248,"{'Hard': {'wins': 0, 'matches': 0, 'win_rate': 0.0}, 'Clay': {'wins': 0, 'matches': 0, 'win_rate': 0.0}, 'Grass': {'wins': 0, 'matches': 2, 'win_rate': 0.0}}",0,2024-07-01
Leo Borg,1,2,3,0.3333333333333333,590,"{'Hard': {'wins': 1, 'matches': 2, 'win_rate': 0.5}, 'Clay': {'wins': 0, 'matches': 1, 'win_rate': 0.0}, 'Grass': {'wins': 0, 'matches': 0, 'win_rate': 0.0}}",1,2024-10-14
Robin Haase,0,1,1,0.0,1199,"{'Hard': {'wins': 0, 'matches': 0, 'win_rate': 0.0}, 'Clay': {'wins': 0, 'matches': 1, 'win_rate': 0.0}, 'Grass': {'wins': 0, 'matches': 0, 'win_rate': 0.0}}",0,2024-07-29
Lukas Pokorny,1,0,1,1.0,589,"{'Hard': {'wins': 0, 'matches': 0, 'win_rate': 0.0}, 'Clay': {'wins': 1, 'matches': 1, 'win_rate': 1.0}, 'Grass': {'wins': 0, 'matches': 0, 'win_rate': 0.0}}",1,2024-02-02
Borna Coric,12,19,31,0.3870967741935484,96,"{'Hard': {'wins': 9, 'matches': 22, 'win_rate': 0.4090909090909091}, 'Clay': {'wins': 2, 'matches': 7, 'win_rate': 0.2857142857142857}, 'Grass': {'wins': 1, 'matches': 2, 'win_rate': 0.5}}",4,2024-10-14
Michael Agwi,2,2,4,0.5,487,"{'Hard': {'wins': 0, 'matches': 2, 'win_rate': 0.0}, 'Clay': {'wins': 2, 'matches': 2, 'win_rate': 1.0}, 'Grass': {'wins': 0, 'matches': 0, 'win_rate': 0.0}}",2,2024-09-13
Viktor Durasovic,1,0,1,1.0,413,"{'Hard': {'wins': 1, 'matches': 1, 'win_rate': 1.0}, 'Clay': {'wins': 0, 'matches': 0, 'win_rate': 0.0}, 'Grass': {'wins': 0, 'matches': 0, 'win_rate': 0.0}}",1,2024-02-02
Moez Echargui,1,1,2,0.5,382,"{'Hard': {'wins': 1, 'matches': 1, 'win_rate': 1.0}, 'Clay': {'wins': 0, 'matches': 1, 'win_rate': 0.0}, 'Grass': {'wins': 0, 'matches': 0, 'win_rate': 0.0}}",1,2024-07-29
Joao Fonseca,12,7,19,0.631578947368421,145,"{'Hard': {'wins': 7, 'matches': 8, 'win_rate': 0.875}, 'Clay': {'wins': 5, 'matches': 10, 'win_rate': 0.5}, 'Grass': {'wins': 0, 'matches': 1, 'win_rate': 0.0}}",7,2024-12-18
Oleksii Krutykh,0,2,2,0.0,493,"{'Hard': {'wins': 0, 'matches': 2, 'win_rate': 0.0}, 'Clay': {'wins': 0, 'matches': 0, 'win_rate': 0.0}, 'Grass': {'wins': 0, 'matches': 0, 'win_rate': 0.0}}",0,2024-09-13
Rigele Te,0,1,1,0.0,636,"{'Hard': {'wins': 0, 'matches': 1, 'win_rate': 0.0}, 'Clay': {'wins': 0, 'matches': 0, 'win_rate': 0.0}, 'Grass': {'wins': 0, 'matches': 0, 'win_rate': 0.0}}",0,2024-09-13
Siddharth Vishwakarma,0,1,1,0.0,588,"{'Hard': {'wins': 0, 'matches': 1, 'win_rate': 0.0}, 'Clay': {'wins': 0, 'matches': 0, 'win_rate': 0.0}, 'Grass': {'wins': 0, 'matches': 0, 'win_rate': 0.0}}",0,2024-09-14
Antoine Escoffier,0,1,1,0.0,172,"{'Hard': {'wins': 0, 'matches': 1, 'win_rate': 0.0}, 'Clay': {'wins': 0, 'matches': 0, 'win_rate': 0.0}, 'Grass': {'wins': 0, 'matches': 0, 'win_rate': 0.0}}",0,2024-01-29
Yu Hsiou Hsu,0,1,1,0.0,230,"{'Hard': {'wins': 0, 'matches': 1, 'win_rate': 0.0}, 'Clay': {'wins': 0, 'matches': 0, 'win_rate': 0.0}, 'Grass': {'wins': 0, 'matches': 0, 'win_rate': 0.0}}",0,2024-02-03
Saba Purtseladze,1,3,4,0.25,427,"{'Hard': {'wins': 1, 'matches': 4, 'win_rate': 0.25}, 'Clay': {'wins': 0, 'matches': 0, 'win_rate': 0.0}, 'Grass': {'wins': 0, 'matches': 0, 'win_rate': 0.0}}",1,2024-09-14
Robert Strombachs,0,1,1,0.0,346,"{'Hard': {'wins': 0, 'matches': 1, 'win_rate': 0.0}, 'Clay': {'wins': 0, 'matches': 0, 'win_rate': 0.0}, 'Grass': {'wins': 0, 'matches': 0, 'win_rate': 0.0}}",0,2024-02-02
Nicholas David Ionel,0,1,1,0.0,265,"{'Hard': {'wins': 0, 'matches': 1, 'win_rate': 0.0}, 'Clay': {'wins': 0, 'matches': 0, 'win_rate': 0.0}, 'Grass': {'wins': 0, 'matches': 0, 'win_rate': 0.0}}",0,2024-02-03
Ioannis Xilas,1,1,2,0.5,770,"{'Hard': {'wins': 1, 'matches': 2, 'win_rate': 0.5}, 'Clay': {'wins': 0, 'matches': 0, 'win_rate': 0.0}, 'Grass': {'wins': 0, 'matches': 0, 'win_rate': 0.0}}",1,2024-09-14
Milos Raonic,6,6,12,0.5,177,"{'Hard': {'wins': 3, 'matches': 6, 'win_rate': 0.5}, 'Clay': {'wins': 0, 'matches': 1, 'win_rate': 0.0}, 'Grass': {'wins': 3, 'matches': 5, 'win_rate': 0.6}}",6,2024-07-29
Marc Andrea Huesler,4,7,11,0.36363636363636365,152,"{'Hard': {'wins': 2, 'matches': 6, 'win_rate': 0.3333333333333333}, 'Clay': {'wins': 2, 'matches': 4, 'win_rate': 0.5}, 'Grass': {'wins': 0, 'matches': 1, 'win_rate': 0.0}}",4,2024-10-14
Jose Rubin Statham,0,1,1,0.0,837,"{'Hard': {'wins': 0, 'matches': 1, 'win_rate': 0.0}, 'Clay': {'wins': 0, 'matches': 0, 'win_rate': 0.0}, 'Grass': {'wins': 0, 'matches': 0, 'win_rate': 0.0}}",0,2024-09-14
Oleksandr Ovcharenko,0,1,1,0.0,416,"{'Hard': {'wins': 0, 'matches': 1, 'win_rate': 0.0}, 'Clay': {'wins': 0, 'matches': 0, 'win_rate': 0.0}, 'Grass': {'wins': 0, 'matches': 0, 'win_rate': 0.0}}",0,2024-09-13
Otto Virtanen,4,7,11,0.36363636363636365,116,"{'Hard': {'wins': 3, 'matches': 8, 'win_rate': 0.375}, 'Clay': {'wins': 0, 'matches': 1, 'win_rate': 0.0}, 'Grass': {'wins': 1, 'matches': 2, 'win_rate': 0.5}}",3,2024-10-14
Adam Neff,0,1,1,0.0,829,"{'Hard': {'wins': 0, 'matches': 1, 'win_rate': 0.0}, 'Clay': {'wins': 0, 'matches': 0, 'win_rate': 0.0}, 'Grass': {'wins': 0, 'matches': 0, 'win_rate': 0.0}}",0,2024-02-05
Yibing Wu,2,3,5,0.4,560,"{'Hard': {'wins': 2, 'matches': 4, 'win_rate': 0.5}, 'Clay': {'wins': 0, 'matches': 1, 'win_rate': 0.0}, 'Grass': {'wins': 0, 'matches': 0, 'win_rate': 0.0}}",2,2024-10-02
Yshai Oliel,2,1,3,0.6666666666666666,463,"{'Hard': {'wins': 2, 'matches': 3, 'win_rate': 0.6666666666666666}, 'Clay': {'wins': 0, 'matches': 0, 'win_rate': 0.0}, 'Grass': {'wins': 0, 'matches': 0, 'win_rate': 0.0}}",2,2024-09-13
Jaime Faria,0,4,4,0.0,157,"{'Hard': {'wins': 0, 'matches': 2, 'win_rate': 0.0}, 'Clay': {'wins': 0, 'matches': 2, 'win_rate': 0.0}, 'Grass': {'wins': 0, 'matches': 0, 'win_rate': 0.0}}",0,2024-09-13
Stefano Napolitano,2,3,5,0.4,125,"{'Hard': {'wins': 0, 'matches': 0, 'win_rate': 0.0}, 'Clay': {'wins': 2, 'matches': 4, 'win_rate': 0.5}, 'Grass': {'wins': 0, 'matches': 1, 'win_rate': 0.0}}",2,2024-07-15
Andrey Rublev,43,27,70,0.6142857142857143,8,"{'Hard': {'wins': 32, 'matches': 51, 'win_rate': 0.6274509803921569}, 'Clay': {'wins': 11, 'matches': 17, 'win_rate': 0.6470588235294118}, 'Grass': {'wins': 0, 'matches': 2, 'win_rate': 0.0}}",4,2024-11-11
Ben Shelton,42,26,68,0.6176470588235294,21,"{'Hard': {'wins': 30, 'matches': 48, 'win_rate': 0.625}, 'Clay': {'wins': 8, 'matches': 12, 'win_rate': 0.6666666666666666}, 'Grass': {'wins': 4, 'matches': 8, 'win_rate': 0.5}}",7,2024-11-21
Elliot Benchetrit,1,2,3,0.3333333333333333,670,"{'Hard': {'wins': 1, 'matches': 1, 'win_rate': 1.0}, 'Clay': {'wins': 0, 'matches': 2, 'win_rate': 0.0}, 'Grass': {'wins': 0, 'matches': 0, 'win_rate': 0.0}}",1,2024-09-14
Tung Lin Wu,2,1,3,0.6666666666666666,318,"{'Hard': {'wins': 2, 'matches': 3, 'win_rate': 0.6666666666666666}, 'Clay': {'wins': 0, 'matches': 0, 'win_rate': 0.0}, 'Grass': {'wins': 0, 'matches': 0, 'win_rate': 0.0}}",2,2024-09-14
Harold Mayot,4,9,13,0.3076923076923077,107,"{'Hard': {'wins': 3, 'matches': 8, 'win_rate': 0.375}, 'Clay': {'wins': 1, 'matches': 4, 'win_rate': 0.25}, 'Grass': {'wins': 0, 'matches': 1, 'win_rate': 0.0}}",2,2024-11-04
Chak Lam Coleman Wong,0,1,1,0.0,999,"{'Hard': {'wins': 0, 'matches': 1, 'win_rate': 0.0}, 'Clay': {'wins': 0, 'matches': 0, 'win_rate': 0.0}, 'Grass': {'wins': 0, 'matches': 0, 'win_rate': 0.0}}",0,2024-01-01
Fabian Marozsan,23,29,52,0.4423076923076923,59,"{'Hard': {'wins': 17, 'matches': 34, 'win_rate': 0.5}, 'Clay': {'wins': 5, 'matches': 13, 'win_rate': 0.38461538461538464}, 'Grass': {'wins': 1, 'matches': 5, 'win_rate': 0.2}}",4,2024-11-04
Steven Diez,0,2,2,0.0,314,"{'Hard': {'wins': 0, 'matches': 2, 'win_rate': 0.0}, 'Clay': {'wins': 0, 'matches': 0, 'win_rate': 0.0}, 'Grass': {'wins': 0, 'matches': 0, 'win_rate': 0.0}}",0,2024-01-01
Hamid Reza Nadaf,0,1,1,0.0,1588,"{'Hard': {'wins': 0, 'matches': 0, 'win_rate': 0.0}, 'Clay': {'wins': 0, 'matches': 1, 'win_rate': 0.0}, 'Grass': {'wins': 0, 'matches': 0, 'win_rate': 0.0}}",0,2024-03-15
Jason Kubler,1,2,3,0.3333333333333333,113,"{'Hard': {'wins': 1, 'matches': 3, 'win_rate': 0.3333333333333333}, 'Clay': {'wins': 0, 'matches': 0, 'win_rate': 0.0}, 'Grass': {'wins': 0, 'matches': 0, 'win_rate': 0.0}}",1,2024-01-15
Yassine Dlimi,1,1,2,0.5,1123,"{'Hard': {'wins': 1, 'matches': 1, 'win_rate': 1.0}, 'Clay': {'wins': 0, 'matches': 1, 'win_rate': 0.0}, 'Grass': {'wins': 0, 'matches': 0, 'win_rate': 0.0}}",1,2024-09-14
Thiago Agustin Tirante,6,6,12,0.5,121,"{'Hard': {'wins': 0, 'matches': 1, 'win_rate': 0.0}, 'Clay': {'wins': 6, 'matches': 11, 'win_rate': 0.5454545454545454}, 'Grass': {'wins': 0, 'matches': 0, 'win_rate': 0.0}}",5,2024-10-14
Ki Lung Ng,0,1,1,0.0,2102,"{'Hard': {'wins': 0, 'matches': 1, 'win_rate': 0.0}, 'Clay': {'wins': 0, 'matches': 0, 'win_rate': 0.0}, 'Grass': {'wins': 0, 'matches': 0, 'win_rate': 0.0}}",0,2024-09-14
Ivan Gakhov,0,1,1,0.0,280,"{'Hard': {'wins': 0, 'matches': 0, 'win_rate': 0.0}, 'Clay': {'wins': 0, 'matches': 1, 'win_rate': 0.0}, 'Grass': {'wins': 0, 'matches': 0, 'win_rate': 0.0}}",0,2024-04-15
Steve Johnson,0,1,1,0.0,246,"{'Hard': {'wins': 0, 'matches': 1, 'win_rate': 0.0}, 'Clay': {'wins': 0, 'matches': 0, 'win_rate': 0.0}, 'Grass': {'wins': 0, 'matches': 0, 'win_rate': 0.0}}",0,2024-02-05
Altug Celikbilek,1,0,1,1.0,371,"{'Hard': {'wins': 1, 'matches': 1, 'win_rate': 1.0}, 'Clay': {'wins': 0, 'matches': 0, 'win_rate': 0.0}, 'Grass': {'wins': 0, 'matches': 0, 'win_rate': 0.0}}",1,2024-02-02
Pablo Carreno Busta,8,8,16,0.5,203,"{'Hard': {'wins': 8, 'matches': 14, 'win_rate': 0.5714285714285714}, 'Clay': {'wins': 0, 'matches': 1, 'win_rate': 0.0}, 'Grass': {'wins': 0, 'matches': 1, 'win_rate': 0.0}}",6,2024-10-02
Albert Ramos,3,9,12,0.25,122,"{'Hard': {'wins': 0, 'matches': 2, 'win_rate': 0.0}, 'Clay': {'wins': 3, 'matches': 10, 'win_rate': 0.3}, 'Grass': {'wins': 0, 'matches': 0, 'win_rate': 0.0}}",3,2024-08-26
Reilly Opelka,7,8,15,0.4666666666666667,309,"{'Hard': {'wins': 4, 'matches': 11, 'win_rate': 0.36363636363636365}, 'Clay': {'wins': 0, 'matches': 0, 'win_rate': 0.0}, 'Grass': {'wins': 3, 'matches': 4, 'win_rate': 0.75}}",4,2024-10-02
David Jorda Sanchis,1,1,2,0.5,329,"{'Hard': {'wins': 0, 'matches': 0, 'win_rate': 0.0}, 'Clay': {'wins': 1, 'matches': 2, 'win_rate': 0.5}, 'Grass': {'wins': 0, 'matches': 0, 'win_rate': 0.0}}",1,2024-04-01
Yi Zhou,4,4,8,0.5,440,"{'Hard': {'wins': 4, 'matches': 8, 'win_rate': 0.5}, 'Clay': {'wins': 0, 'matches': 0, 'win_rate': 0.0}, 'Grass': {'wins': 0, 'matches': 0, 'win_rate': 0.0}}",4,2024-10-02
Holger Rune,46,23,69,0.6666666666666666,13,"{'Hard': {'wins': 32, 'matches': 47, 'win_rate': 0.6808510638297872}, 'Clay': {'wins': 11, 'matches': 17, 'win_rate': 0.6470588235294118}, 'Grass': {'wins': 3, 'matches': 5, 'win_rate': 0.6}}",7,2024-10-28
Juncheng Shang,25,22,47,0.5319148936170213,50,"{'Hard': {'wins': 21, 'matches': 38, 'win_rate': 0.5526315789473685}, 'Clay': {'wins': 1, 'matches': 4, 'win_rate': 0.25}, 'Grass': {'wins': 3, 'matches': 5, 'win_rate': 0.6}}",2,2024-12-18
Matic Kriznik,0,2,2,0.0,1274,"{'Hard': {'wins': 0, 'matches': 2, 'win_rate': 0.0}, 'Clay': {'wins': 0, 'matches': 0, 'win_rate': 0.0}, 'Grass': {'wins': 0, 'matches': 0, 'win_rate': 0.0}}",0,2024-02-02
Nishesh Basavareddy,1,2,3,0.3333333333333333,138,"{'Hard': {'wins': 1, 'matches': 3, 'win_rate': 0.3333333333333333}, 'Clay': {'wins': 0, 'matches': 0, 'win_rate': 0.0}, 'Grass': {'wins': 0, 'matches': 0, 'win_rate': 0.0}}",1,2024-12-18
Emilio Nava,1,5,6,0.16666666666666666,148,"{'Hard': {'wins': 1, 'matches': 5, 'win_rate': 0.2}, 'Clay': {'wins': 0, 'matches': 0, 'win_rate': 0.0}, 'Grass': {'wins': 0, 'matches': 1, 'win_rate': 0.0}}",1,2024-07-15
Edas Butvilas,0,1,1,0.0,368,"{'Hard': {'wins': 0, 'matches': 1, 'win_rate': 0.0}, 'Clay': {'wins': 0, 'matches': 0, 'win_rate': 0.0}, 'Grass': {'wins': 0, 'matches': 0, 'win_rate': 0.0}}",0,2024-09-13
Mohamed Safwat,2,1,3,0.6666666666666666,415,"{'Hard': {'wins': 0, 'matches': 0, 'win_rate': 0.0}, 'Clay': {'wins': 2, 'matches': 3, 'win_rate': 0.6666666666666666}, 'Grass': {'wins': 0, 'matches': 0, 'win_rate': 0.0}}",2,2024-09-13
Bernabe Zapata Miralles,1,8,9,0.1111111111111111,144,"{'Hard': {'wins': 0, 'matches': 4, 'win_rate': 0.0}, 'Clay': {'wins': 1, 'matches': 5, 'win_rate': 0.2}, 'Grass': {'wins': 0, 'matches': 0, 'win_rate': 0.0}}",1,2024-03-04
Alex Molcan,1,1,2,0.5,135,"{'Hard': {'wins': 0, 'matches': 0, 'win_rate': 0.0}, 'Clay': {'wins': 1, 'matches': 2, 'win_rate': 0.5}, 'Grass': {'wins': 0, 'matches': 0, 'win_rate': 0.0}}",1,2024-02-26
Strong Kirchheimer,0,1,1,0.0,511,"{'Hard': {'wins': 0, 'matches': 1, 'win_rate': 0.0}, 'Clay': {'wins': 0, 'matches': 0, 'win_rate': 0.0}, 'Grass': {'wins': 0, 'matches': 0, 'win_rate': 0.0}}",0,2024-08-19
Dominic Thiem,2,9,11,0.18181818181818182,318,"{'Hard': {'wins': 1, 'matches': 5, 'win_rate': 0.2}, 'Clay': {'wins': 1, 'matches': 5, 'win_rate': 0.2}, 'Grass': {'wins': 0, 'matches': 1, 'win_rate': 0.0}}",2,2024-10-21
Dominik Koepfer,16,19,35,0.45714285714285713,81,"{'Hard': {'wins': 8, 'matches': 16, 'win_rate': 0.5}, 'Clay': {'wins': 6, 'matches': 15, 'win_rate': 0.4}, 'Grass': {'wins': 2, 'matches': 4, 'win_rate': 0.5}}",4,2024-10-14
Jesse Flores,0,1,1,0.0,900,"{'Hard': {'wins': 0, 'matches': 1, 'win_rate': 0.0}, 'Clay': {'wins': 0, 'matches': 0, 'win_rate': 0.0}, 'Grass': {'wins': 0, 'matches': 0, 'win_rate': 0.0}}",0,2024-02-02
Emilio Gomez,0,1,1,0.0,307,"{'Hard': {'wins': 0, 'matches': 0, 'win_rate': 0.0}, 'Clay': {'wins': 0, 'matches': 1, 'win_rate': 0.0}, 'Grass': {'wins': 0, 'matches': 0, 'win_rate': 0.0}}",0,2024-02-02
Rafael Nadal,12,8,20,0.6,154,"{'Hard': {'wins': 2, 'matches': 4, 'win_rate': 0.5}, 'Clay': {'wins': 10, 'matches': 16, 'win_rate': 0.625}, 'Grass': {'wins': 0, 'matches': 0, 'win_rate': 0.0}}",5,2024-11-19
Thiago Seyboth Wild,20,25,45,0.4444444444444444,78,"{'Hard': {'wins': 8, 'matches': 19, 'win_rate': 0.42105263157894735}, 'Clay': {'wins': 10, 'matches': 22, 'win_rate': 0.45454545454545453}, 'Grass': {'wins': 2, 'matches': 4, 'win_rate': 0.5}}",4,2024-10-21
Sumit Nagal,5,16,21,0.23809523809523808,83,"{'Hard': {'wins': 1, 'matches': 9, 'win_rate': 0.1111111111111111}, 'Clay': {'wins': 4, 'matches': 11, 'win_rate': 0.36363636363636365}, 'Grass': {'wins': 0, 'matches': 1, 'win_rate': 0.0}}",2,2024-11-04
August Holmgren,2,1,3,0.6666666666666666,166,"{'Hard': {'wins': 1, 'matches': 1, 'win_rate': 1.0}, 'Clay': {'wins': 1, 'matches': 2, 'win_rate': 0.5}, 'Grass': {'wins': 0, 'matches': 0, 'win_rate': 0.0}}",2,2024-09-14
Diego Schwartzman,0,8,8,0.0,244,"{'Hard': {'wins': 0, 'matches': 4, 'win_rate': 0.0}, 'Clay': {'wins': 0, 'matches': 4, 'win_rate': 0.0}, 'Grass': {'wins': 0, 'matches': 0, 'win_rate': 0.0}}",0,2024-08-26
Pedro Cachin,2,15,17,0.11764705882352941,110,"{'Hard': {'wins': 0, 'matches': 4, 'win_rate': 0.0}, 'Clay': {'wins': 2, 'matches': 13, 'win_rate': 0.15384615384615385}, 'Grass': {'wins': 0, 'matches': 0, 'win_rate': 0.0}}",2,2024-07-15
Mili Poljicak,0,1,1,0.0,481,"{'Hard': {'wins': 0, 'matches': 0, 'win_rate': 0.0}, 'Clay': {'wins': 0, 'matches': 1, 'win_rate': 0.0}, 'Grass': {'wins': 0, 'matches': 0, 'win_rate': 0.0}}",0,2024-07-22
Lukas Neumayer,3,1,4,0.75,262,"{'Hard': {'wins': 0, 'matches': 0, 'win_rate': 0.0}, 'Clay': {'wins': 3, 'matches': 4, 'win_rate': 0.75}, 'Grass': {'wins': 0, 'matches': 0, 'win_rate': 0.0}}",3,2024-09-13
Bu Yunchaokete,9,6,15,0.6,72,"{'Hard': {'wins': 9, 'matches': 15, 'win_rate': 0.6}, 'Clay': {'wins': 0, 'matches': 0, 'win_rate': 0.0}, 'Grass': {'wins': 0, 'matches': 0, 'win_rate': 0.0}}",7,2024-11-04
Zhizhen Zhang,25,29,54,0.46296296296296297,47,"{'Hard': {'wins': 12, 'matches': 30, 'win_rate': 0.4}, 'Clay': {'wins': 9, 'matches': 16, 'win_rate': 0.5625}, 'Grass': {'wins': 4, 'matches': 8, 'win_rate': 0.5}}",4,2024-10-28
Andy Murray,6,12,18,0.3333333333333333,129,"{'Hard': {'wins': 5, 'matches': 13, 'win_rate': 0.38461538461538464}, 'Clay': {'wins': 0, 'matches': 2, 'win_rate': 0.0}, 'Grass': {'wins': 1, 'matches': 3, 'win_rate': 0.3333333333333333}}",4,2024-06-17
Nerman Fatic,1,0,1,1.0,204,"{'Hard': {'wins': 1, 'matches': 1, 'win_rate': 1.0}, 'Clay': {'wins': 0, 'matches': 0, 'win_rate': 0.0}, 'Grass': {'wins': 0, 'matches': 0, 'win_rate': 0.0}}",1,2024-02-03
Alex Bolt,3,3,6,0.5,210,"{'Hard': {'wins': 1, 'matches': 2, 'win_rate': 0.5}, 'Clay': {'wins': 0, 'matches': 0, 'win_rate': 0.0}, 'Grass': {'wins': 2, 'matches': 4, 'win_rate': 0.5}}",3,2024-07-15
Adam Walton,3,11,14,0.21428571428571427,94,"{'Hard': {'wins': 1, 'matches': 9, 'win_rate': 0.1111111111111111}, 'Clay': {'wins': 0, 'matches': 1, 'win_rate': 0.0}, 'Grass': {'wins': 2, 'matches': 4, 'win_rate': 0.5}}",3,2024-09-18
Petr Nesterov,1,1,2,0.5,413,"{'Hard': {'wins': 1, 'matches': 1, 'win_rate': 1.0}, 'Clay': {'wins': 0, 'matches': 1, 'win_rate': 0.0}, 'Grass': {'wins': 0, 'matches': 0, 'win_rate': 0.0}}",1,2024-09-14
Oliver Ojakaar,2,0,2,1.0,939,"{'Hard': {'wins': 0, 'matches': 0, 'win_rate': 0.0}, 'Clay': {'wins': 2, 'matches': 2, 'win_rate': 1.0}, 'Grass': {'wins': 0, 'matches': 0, 'win_rate': 0.0}}",2,2024-03-15
Matthew Ebden,0,1,1,0.0,999,"{'Hard': {'wins': 0, 'matches': 0, 'win_rate': 0.0}, 'Clay': {'wins': 0, 'matches': 1, 'win_rate': 0.0}, 'Grass': {'wins': 0, 'matches': 0, 'win_rate': 0.0}}",0,2024-07-29
Lloyd Harris,1,2,3,0.3333333333333333,118,"{'Hard': {'wins': 0, 'matches': 1, 'win_rate': 0.0}, 'Clay': {'wins': 0, 'matches': 0, 'win_rate': 0.0}, 'Grass': {'wins': 1, 'matches': 2, 'win_rate': 0.5}}",1,2024-07-01
Nicolas Moreno De Alboran,6,9,15,0.4,143,"{'Hard': {'wins': 1, 'matches': 4, 'win_rate': 0.25}, 'Clay': {'wins': 5, 'matches': 11, 'win_rate': 0.45454545454545453}, 'Grass': {'wins': 0, 'matches': 0, 'win_rate': 0.0}}",5,2024-07-22
Carlos Alcaraz,54,13,67,0.8059701492537313,3,"{'Hard': {'wins': 29, 'matches': 37, 'win_rate': 0.7837837837837838}, 'Clay': {'wins': 17, 'matches': 21, 'win_rate': 0.8095238095238095}, 'Grass': {'wins': 8, 'matches': 9, 'win_rate': 0.8888888888888888}}",6,2024-11-19
Nikolas Sanchez Izquierdo,0,1,1,0.0,260,"{'Hard': {'wins': 0, 'matches': 0, 'win_rate': 0.0}, 'Clay': {'wins': 0, 'matches': 1, 'win_rate': 0.0}, 'Grass': {'wins': 0, 'matches': 0, 'win_rate': 0.0}}",0,2024-05-20
Casper Ruud,52,26,78,0.6666666666666666,7,"{'Hard': {'wins': 26, 'matches': 44, 'win_rate': 0.5909090909090909}, 'Clay': {'wins': 25, 'matches': 32, 'win_rate': 0.78125}, 'Grass': {'wins': 1, 'matches': 2, 'win_rate': 0.5}}",3,2024-11-11
Jack Draper,39,22,61,0.639344262295082,15,"{'Hard': {'wins': 26, 'matches': 39, 'win_rate': 0.6666666666666666}, 'Clay': {'wins': 5, 'matches': 12, 'win_rate': 0.4166666666666667}, 'Grass': {'wins': 8, 'matches': 10, 'win_rate': 0.8}}",8,2024-10-28
Yosuke Watanuki,2,3,5,0.4,336,"{'Hard': {'wins': 2, 'matches': 4, 'win_rate': 0.5}, 'Clay': {'wins': 0, 'matches': 1, 'win_rate': 0.0}, 'Grass': {'wins': 0, 'matches': 0, 'win_rate': 0.0}}",2,2024-10-02
Tennys Sandgren,0,1,1,0.0,281,"{'Hard': {'wins': 0, 'matches': 1, 'win_rate': 0.0}, 'Clay': {'wins': 0, 'matches': 0, 'win_rate': 0.0}, 'Grass': {'wins': 0, 'matches': 0, 'win_rate': 0.0}}",0,2024-02-05
Valentin Vacherot,2,3,5,0.4,116,"{'Hard': {'wins': 0, 'matches': 0, 'win_rate': 0.0}, 'Clay': {'wins': 2, 'matches': 5, 'win_rate': 0.4}, 'Grass': {'wins': 0, 'matches': 0, 'win_rate': 0.0}}",2,2024-05-27
Martins Rocens,0,1,1,0.0,1763,"{'Hard': {'wins': 0, 'matches': 1, 'win_rate': 0.0}, 'Clay': {'wins': 0, 'matches': 0, 'win_rate': 0.0}, 'Grass': {'wins': 0, 'matches': 0, 'win_rate': 0.0}}",0,2024-02-02
Khumoun Sultanov,2,1,3,0.6666666666666666,236,"{'Hard': {'wins': 2, 'matches': 3, 'win_rate': 0.6666666666666666}, 'Clay': {'wins': 0, 'matches': 0, 'win_rate': 0.0}, 'Grass': {'wins': 0, 'matches': 0, 'win_rate': 0.0}}",2,2024-09-13
Cameron Norrie,21,19,40,0.525,57,"{'Hard': {'wins': 11, 'matches': 19, 'win_rate': 0.5789473684210527}, 'Clay': {'wins': 8, 'matches': 16, 'win_rate': 0.5}, 'Grass': {'wins': 2, 'matches': 5, 'win_rate': 0.4}}",6,2024-11-04
Sebastian Ofner,17,24,41,0.4146341463414634,58,"{'Hard': {'wins': 7, 'matches': 14, 'win_rate': 0.5}, 'Clay': {'wins': 6, 'matches': 19, 'win_rate': 0.3157894736842105}, 'Grass': {'wins': 4, 'matches': 8, 'win_rate': 0.5}}",5,2024-08-26
Lorenzo Sonego,21,29,50,0.42,51,"{'Hard': {'wins': 12, 'matches': 30, 'win_rate': 0.4}, 'Clay': {'wins': 6, 'matches': 14, 'win_rate': 0.42857142857142855}, 'Grass': {'wins': 3, 'matches': 6, 'win_rate': 0.5}}",2,2024-11-04
Ernesto Escobedo,0,4,4,0.0,493,"{'Hard': {'wins': 0, 'matches': 2, 'win_rate': 0.0}, 'Clay': {'wins': 0, 'matches': 2, 'win_rate': 0.0}, 'Grass': {'wins': 0, 'matches': 0, 'win_rate': 0.0}}",0,2024-02-26
Petros Chrysochos,0,1,1,0.0,1410,"{'Hard': {'wins': 0, 'matches': 1, 'win_rate': 0.0}, 'Clay': {'wins': 0, 'matches': 0, 'win_rate': 0.0}, 'Grass': {'wins': 0, 'matches': 0, 'win_rate': 0.0}}",0,2024-02-03
Adria Soriano Barrera,1,2,3,0.3333333333333333,460,"{'Hard': {'wins': 0, 'matches': 1, 'win_rate': 0.0}, 'Clay': {'wins': 1, 'matches': 2, 'win_rate': 0.5}, 'Grass': {'wins': 0, 'matches': 0, 'win_rate': 0.0}}",1,2024-09-14
Heve Kelley,0,1,1,0.0,999,"{'Hard': {'wins': 0, 'matches': 1, 'win_rate': 0.0}, 'Clay': {'wins': 0, 'matches': 0, 'win_rate': 0.0}, 'Grass': {'wins': 0, 'matches': 0, 'win_rate': 0.0}}",0,2024-02-02
Mirza Basic,1,1,2,0.5,579,"{'Hard': {'wins': 1, 'matches': 2, 'win_rate': 0.5}, 'Clay': {'wins': 0, 'matches': 0, 'win_rate': 0.0}, 'Grass': {'wins': 0, 'matches': 0, 'win_rate': 0.0}}",1,2024-09-14
Theo Papamalamis,0,1,1,0.0,721,"{'Hard': {'wins': 0, 'matches': 1, 'win_rate': 0.0}, 'Clay': {'wins': 0, 'matches': 0, 'win_rate': 0.0}, 'Grass': {'wins': 0, 'matches': 0, 'win_rate': 0.0}}",0,2024-11-04
Alejandro Tabilo,33,27,60,0.55,22,"{'Hard': {'wins': 15, 'matches': 30, 'win_rate': 0.5}, 'Clay': {'wins': 11, 'matches': 21, 'win_rate': 0.5238095238095238}, 'Grass': {'wins': 7, 'matches': 9, 'win_rate': 0.7777777777777778}}",4,2024-10-28
Marco Trungelliti,4,4,8,0.5,138,"{'Hard': {'wins': 0, 'matches': 1, 'win_rate': 0.0}, 'Clay': {'wins': 4, 'matches': 7, 'win_rate': 0.5714285714285714}, 'Grass': {'wins': 0, 'matches': 0, 'win_rate': 0.0}}",4,2024-09-18
Chun Hsin Tseng,1,5,6,0.16666666666666666,121,"{'Hard': {'wins': 0, 'matches': 4, 'win_rate': 0.0}, 'Clay': {'wins': 1, 'matches': 2, 'win_rate': 0.5}, 'Grass': {'wins': 0, 'matches': 0, 'win_rate': 0.0}}",1,2024-09-18
Soon Woo Kwon,3,7,10,0.3,344,"{'Hard': {'wins': 2, 'matches': 6, 'win_rate': 0.3333333333333333}, 'Clay': {'wins': 1, 'matches': 3, 'win_rate': 0.3333333333333333}, 'Grass': {'wins': 0, 'matches': 1, 'win_rate': 0.0}}",3,2024-09-13
Benedict Badza,1,0,1,1.0,999,"{'Hard': {'wins': 1, 'matches': 1, 'win_rate': 1.0}, 'Clay': {'wins': 0, 'matches': 0, 'win_rate': 0.0}, 'Grass': {'wins': 0, 'matches': 0, 'win_rate': 0.0}}",1,2024-02-03
Daniel Evans,8,22,30,0.26666666666666666,180,"{'Hard': {'wins': 7, 'matches': 20, 'win_rate': 0.35}, 'Clay': {'wins': 1, 'matches': 8, 'win_rate': 0.125}, 'Grass': {'wins': 0, 'matches': 2, 'win_rate': 0.0}}",4,2024-10-14
Max Hans Rehberg,0,1,1,0.0,473,"{'Hard': {'wins': 0, 'matches': 0, 'win_rate': 0.0}, 'Clay': {'wins': 0, 'matches': 1, 'win_rate': 0.0}, 'Grass': {'wins': 0, 'matches': 0, 'win_rate': 0.0}}",0,2024-04-15
Gabi Adrian Boitan,1,1,2,0.5,364,"{'Hard': {'wins': 1, 'matches': 2, 'win_rate': 0.5}, 'Clay': {'wins': 0, 'matches': 0, 'win_rate': 0.0}, 'Grass': {'wins': 0, 'matches': 0, 'win_rate': 0.0}}",1,2024-09-13
Jiri Lehecka,30,19,49,0.6122448979591837,31,"{'Hard': {'wins': 26, 'matches': 44, 'win_rate': 0.5909090909090909}, 'Clay': {'wins': 4, 'matches': 5, 'win_rate': 0.8}, 'Grass': {'wins': 0, 'matches': 0, 'win_rate': 0.0}}",6,2024-11-04
Francisco Cerundolo,35,31,66,0.5303030303030303,30,"{'Hard': {'wins': 14, 'matches': 29, 'win_rate': 0.4827586206896552}, 'Clay': {'wins': 21, 'matches': 34, 'win_rate': 0.6176470588235294}, 'Grass': {'wins': 0, 'matches': 3, 'win_rate': 0.0}}",6,2024-11-21
Nick Hardt,1,2,3,0.3333333333333333,191,"{'Hard': {'wins': 0, 'matches': 0, 'win_rate': 0.0}, 'Clay': {'wins': 1, 'matches': 3, 'win_rate': 0.3333333333333333}, 'Grass': {'wins': 0, 'matches': 0, 'win_rate': 0.0}}",1,2024-07-15
Darian King,3,1,4,0.75,1230,"{'Hard': {'wins': 3, 'matches': 4, 'win_rate': 0.75}, 'Clay': {'wins': 0, 'matches': 0, 'win_rate': 0.0}, 'Grass': {'wins': 0, 'matches': 0, 'win_rate': 0.0}}",3,2024-09-14
Omar Jasika,0,1,1,0.0,343,"{'Hard': {'wins': 0, 'matches': 1, 'win_rate': 0.0}, 'Clay': {'wins': 0, 'matches': 0, 'win_rate': 0.0}, 'Grass': {'wins': 0, 'matches': 0, 'win_rate': 0.0}}",0,2024-01-15
Eero Vasa,0,4,4,0.0,703,"{'Hard': {'wins': 0, 'matches': 4, 'win_rate': 0.0}, 'Clay': {'wins': 0, 'matches': 0, 'win_rate': 0.0}, 'Grass': {'wins': 0, 'matches': 0, 'win_rate': 0.0}}",0,2024-09-14
Ricardas Berankis,2,0,2,1.0,248,"{'Hard': {'wins': 2, 'matches': 2, 'win_rate': 1.0}, 'Clay': {'wins': 0, 'matches': 0, 'win_rate': 0.0}, 'Grass': {'wins': 0, 'matches': 0, 'win_rate': 0.0}}",2,2024-02-03
Facundo Bagnis,5,3,8,0.625,136,"{'Hard': {'wins': 0, 'matches': 0, 'win_rate': 0.0}, 'Clay': {'wins': 5, 'matches': 8, 'win_rate': 0.625}, 'Grass': {'wins': 0, 'matches': 0, 'win_rate': 0.0}}",5,2024-04-22
Kwok Shun Dasson Chan,0,1,1,0.0,999,"{'Hard': {'wins': 0, 'matches': 1, 'win_rate': 0.0}, 'Clay': {'wins': 0, 'matches': 0, 'win_rate': 0.0}, 'Grass': {'wins': 0, 'matches': 0, 'win_rate': 0.0}}",0,2024-02-03
Luca Nardi,4,12,16,0.25,89,"{'Hard': {'wins': 2, 'matches': 7, 'win_rate': 0.2857142857142857}, 'Clay': {'wins': 1, 'matches': 5, 'win_rate': 0.2}, 'Grass': {'wins': 1, 'matches': 4, 'win_rate': 0.25}}",2,2024-10-02
Alejandro Davidovich Fokina,19,22,41,0.4634146341463415,62,"{'Hard': {'wins': 16, 'matches': 32, 'win_rate': 0.5}, 'Clay': {'wins': 3, 'matches': 8, 'win_rate': 0.375}, 'Grass': {'wins': 0, 'matches': 1, 'win_rate': 0.0}}",3,2024-10-21
Martyn Pawelski,1,0,1,1.0,661,"{'Hard': {'wins': 1, 'matches': 1, 'win_rate': 1.0}, 'Clay': {'wins': 0, 'matches': 0, 'win_rate': 0.0}, 'Grass': {'wins': 0, 'matches': 0, 'win_rate': 0.0}}",1,2024-09-13
Coleman Wong,4,5,9,0.4444444444444444,133,"{'Hard': {'wins': 4, 'matches': 8, 'win_rate': 0.5}, 'Clay': {'wins': 0, 'matches': 0, 'win_rate': 0.0}, 'Grass': {'wins': 0, 'matches': 1, 'win_rate': 0.0}}",4,2024-10-14
Henry Searle,0,2,2,0.0,539,"{'Hard': {'wins': 0, 'matches': 0, 'win_rate': 0.0}, 'Clay': {'wins': 0, 'matches': 0, 'win_rate': 0.0}, 'Grass': {'wins': 0, 'matches': 2, 'win_rate': 0.0}}",0,2024-07-01
Daniel Altmaier,13,23,36,0.3611111111111111,88,"{'Hard': {'wins': 8, 'matches': 19, 'win_rate': 0.42105263157894735}, 'Clay': {'wins': 4, 'matches': 15, 'win_rate': 0.26666666666666666}, 'Grass': {'wins': 1, 'matches': 2, 'win_rate': 0.5}}",3,2024-11-22
Dominic Stricker,4,6,10,0.4,258,"{'Hard': {'wins': 4, 'matches': 8, 'win_rate': 0.5}, 'Clay': {'wins': 0, 'matches': 1, 'win_rate': 0.0}, 'Grass': {'wins': 0, 'matches': 1, 'win_rate': 0.0}}",4,2024-10-21
Thomas Yaka Kofi Setodji,3,1,4,0.75,1240,"{'Hard': {'wins': 3, 'matches': 4, 'win_rate': 0.75}, 'Clay': {'wins': 0, 'matches': 0, 'win_rate': 0.0}, 'Grass': {'wins': 0, 'matches': 0, 'win_rate': 0.0}}",3,2024-09-14
Diego Duran,1,0,1,1.0,999,"{'Hard': {'wins': 1, 'matches': 1, 'win_rate': 1.0}, 'Clay': {'wins': 0, 'matches': 0, 'win_rate': 0.0}, 'Grass': {'wins': 0, 'matches': 0, 'win_rate': 0.0}}",1,2024-02-02
Hamad Medjedovic,9,8,17,0.5294117647058824,156,"{'Hard': {'wins': 4, 'matches': 6, 'win_rate': 0.6666666666666666}, 'Clay': {'wins': 4, 'matches': 9, 'win_rate': 0.4444444444444444}, 'Grass': {'wins': 1, 'matches': 2, 'win_rate': 0.5}}",6,2024-11-04
Kevin Krawietz,0,1,1,0.0,999,"{'Hard': {'wins': 0, 'matches': 1, 'win_rate': 0.0}, 'Clay': {'wins': 0, 'matches': 0, 'win_rate': 0.0}, 'Grass': {'wins': 0, 'matches': 0, 'win_rate': 0.0}}",0,2024-02-02
Rudolf Molleker,1,2,3,0.3333333333333333,197,"{'Hard': {'wins': 0, 'matches': 0, 'win_rate': 0.0}, 'Clay': {'wins': 1, 'matches': 3, 'win_rate': 0.3333333333333333}, 'Grass': {'wins': 0, 'matches': 0, 'win_rate': 0.0}}",1,2024-07-15
Jacob Fearnley,2,3,5,0.4,99,"{'Hard': {'wins': 1, 'matches': 2, 'win_rate': 0.5}, 'Clay': {'wins': 0, 'matches': 0, 'win_rate': 0.0}, 'Grass': {'wins': 1, 'matches': 3, 'win_rate': 0.3333333333333333}}",2,2024-10-14
Timofey Skatov,4,3,7,0.5714285714285714,192,"{'Hard': {'wins': 0, 'matches': 2, 'win_rate': 0.0}, 'Clay': {'wins': 4, 'matches': 5, 'win_rate': 0.8}, 'Grass': {'wins': 0, 'matches': 0, 'win_rate': 0.0}}",4,2024-10-14
Aziz Dougaz,2,2,4,0.5,228,"{'Hard': {'wins': 1, 'matches': 1, 'win_rate': 1.0}, 'Clay': {'wins': 1, 'matches': 3, 'win_rate': 0.3333333333333333}, 'Grass': {'wins': 0, 'matches': 0, 'win_rate': 0.0}}",2,2024-09-13
Flavio Cobolli,35,27,62,0.5645161290322581,31,"{'Hard': {'wins': 22, 'matches': 37, 'win_rate': 0.5945945945945946}, 'Clay': {'wins': 10, 'matches': 18, 'win_rate': 0.5555555555555556}, 'Grass': {'wins': 3, 'matches': 7, 'win_rate': 0.42857142857142855}}",5,2024-10-21
Matavao Fanguna,0,1,1,0.0,999,"{'Hard': {'wins': 0, 'matches': 1, 'win_rate': 0.0}, 'Clay': {'wins': 0, 'matches': 0, 'win_rate': 0.0}, 'Grass': {'wins': 0, 'matches': 0, 'win_rate': 0.0}}",0,2024-02-02
Yannick Hanfmann,20,21,41,0.4878048780487805,95,"{'Hard': {'wins': 9, 'matches': 15, 'win_rate': 0.6}, 'Clay': {'wins': 10, 'matches': 22, 'win_rate': 0.45454545454545453}, 'Grass': {'wins': 1, 'matches': 4, 'win_rate': 0.25}}",8,2024-09-18
Abedallah Shelbayh,0,3,3,0.0,230,"{'Hard': {'wins': 0, 'matches': 2, 'win_rate': 0.0}, 'Clay': {'wins': 0, 'matches': 1, 'win_rate': 0.0}, 'Grass': {'wins': 0, 'matches': 0, 'win_rate': 0.0}}",0,2024-04-01
Sebastian Fanselow,0,1,1,0.0,316,"{'Hard': {'wins': 0, 'matches': 0, 'win_rate': 0.0}, 'Clay': {'wins': 0, 'matches': 1, 'win_rate': 0.0}, 'Grass': {'wins': 0, 'matches': 0, 'win_rate': 0.0}}",0,2024-05-20
Sergey Fomin,0,2,2,0.0,537,"{'Hard': {'wins': 0, 'matches': 2, 'win_rate': 0.0}, 'Clay': {'wins': 0, 'matches': 0, 'win_rate': 0.0}, 'Grass': {'wins': 0, 'matches': 0, 'win_rate': 0.0}}",0,2024-09-13
Kiranpal Pannu,1,2,3,0.3333333333333333,454,"{'Hard': {'wins': 1, 'matches': 3, 'win_rate': 0.3333333333333333}, 'Clay': {'wins': 0, 'matches': 0, 'win_rate': 0.0}, 'Grass': {'wins': 0, 'matches': 0, 'win_rate': 0.0}}",1,2024-09-14
Yanaki Milev,2,1,3,0.6666666666666666,445,"{'Hard': {'wins': 0, 'matches': 1, 'win_rate': 0.0}, 'Clay': {'wins': 2, 'matches': 2, 'win_rate': 1.0}, 'Grass': {'wins': 0, 'matches': 0, 'win_rate': 0.0}}",2,2024-09-14
Kyrian Jacquet,0,1,1,0.0,209,"{'Hard': {'wins': 0, 'matches': 1, 'win_rate': 0.0}, 'Clay': {'wins': 0, 'matches': 0, 'win_rate': 0.0}, 'Grass': {'wins': 0, 'matches': 0, 'win_rate': 0.0}}",0,2024-08-26
Alexander Blockx,0,2,2,0.0,231,"{'Hard': {'wins': 0, 'matches': 2, 'win_rate': 0.0}, 'Clay': {'wins': 0, 'matches': 0, 'win_rate': 0.0}, 'Grass': {'wins': 0, 'matches': 0, 'win_rate': 0.0}}",0,2024-10-14
Alexander Bublik,25,25,50,0.5,33,"{'Hard': {'wins': 16, 'matches': 31, 'win_rate': 0.5161290322580645}, 'Clay': {'wins': 5, 'matches': 11, 'win_rate': 0.45454545454545453}, 'Grass': {'wins': 4, 'matches': 8, 'win_rate': 0.5}}",2,2024-10-28
Daniel Vallejo,1,1,2,0.5,999,"{'Hard': {'wins': 0, 'matches': 0, 'win_rate': 0.0}, 'Clay': {'wins': 1, 'matches': 2, 'win_rate': 0.5}, 'Grass': {'wins': 0, 'matches': 0, 'win_rate': 0.0}}",1,2024-02-03
Brandon Nakashima,28,23,51,0.5490196078431373,37,"{'Hard': {'wins': 16, 'matches': 30, 'win_rate': 0.5333333333333333}, 'Clay': {'wins': 5, 'matches': 10, 'win_rate': 0.5}, 'Grass': {'wins': 7, 'matches': 11, 'win_rate': 0.6363636363636364}}",3,2024-11-04
Orel Kimhi,0,1,1,0.0,456,"{'Hard': {'wins': 0, 'matches': 1, 'win_rate': 0.0}, 'Clay': {'wins': 0, 'matches': 0, 'win_rate': 0.0}, 'Grass': {'wins': 0, 'matches': 0, 'win_rate': 0.0}}",0,2024-02-03
Radu Albot,5,7,12,0.4166666666666667,138,"{'Hard': {'wins': 2, 'matches': 6, 'win_rate': 0.3333333333333333}, 'Clay': {'wins': 3, 'matches': 4, 'win_rate': 0.75}, 'Grass': {'wins': 0, 'matches': 2, 'win_rate': 0.0}}",3,2024-08-26
Lorenzo Musetti,41,28,69,0.5942028985507246,17,"{'Hard': {'wins': 17, 'matches': 34, 'win_rate': 0.5}, 'Clay': {'wins': 12, 'matches': 20, 'win_rate': 0.6}, 'Grass': {'wins': 12, 'matches': 15, 'win_rate': 0.8}}",5,2024-11-21
Javier Barranco Cosano,0,1,1,0.0,254,"{'Hard': {'wins': 0, 'matches': 0, 'win_rate': 0.0}, 'Clay': {'wins': 0, 'matches': 1, 'win_rate': 0.0}, 'Grass': {'wins': 0, 'matches': 0, 'win_rate': 0.0}}",0,2024-05-20
Tommy Paul,45,19,64,0.703125,12,"{'Hard': {'wins': 25, 'matches': 38, 'win_rate': 0.6578947368421053}, 'Clay': {'wins': 10, 'matches': 14, 'win_rate': 0.7142857142857143}, 'Grass': {'wins': 10, 'matches': 12, 'win_rate': 0.8333333333333334}}",7,2024-10-28
Alexandre Muller,17,20,37,0.4594594594594595,68,"{'Hard': {'wins': 9, 'matches': 21, 'win_rate': 0.42857142857142855}, 'Clay': {'wins': 7, 'matches': 14, 'win_rate': 0.5}, 'Grass': {'wins': 1, 'matches': 2, 'win_rate': 0.5}}",4,2024-11-04
Murkel Alejandro Dellien Velasco,1,1,2,0.5,183,"{'Hard': {'wins': 0, 'matches': 0, 'win_rate': 0.0}, 'Clay': {'wins': 1, 'matches': 2, 'win_rate': 0.5}, 'Grass': {'wins': 0, 'matches': 0, 'win_rate': 0.0}}",1,2024-09-13
Alvaro Guillen Meza,0,1,1,0.0,312,"{'Hard': {'wins': 0, 'matches': 0, 'win_rate': 0.0}, 'Clay': {'wins': 0, 'matches': 1, 'win_rate': 0.0}, 'Grass': {'wins': 0, 'matches': 0, 'win_rate': 0.0}}",0,2024-02-02
Borna Gojo,1,2,3,0.3333333333333333,439,"{'Hard': {'wins': 1, 'matches': 3, 'win_rate': 0.3333333333333333}, 'Clay': {'wins': 0, 'matches': 0, 'win_rate': 0.0}, 'Grass': {'wins': 0, 'matches': 0, 'win_rate': 0.0}}",1,2024-09-13
Younes Lalami Laaroussi,0,1,1,0.0,1074,"{'Hard': {'wins': 0, 'matches': 0, 'win_rate': 0.0}, 'Clay': {'wins': 0, 'matches': 1, 'win_rate': 0.0}, 'Grass': {'wins': 0, 'matches': 0, 'win_rate': 0.0}}",0,2024-09-14
Romain Arneodo,1,0,1,1.0,999,"{'Hard': {'wins': 0, 'matches': 0, 'win_rate': 0.0}, 'Clay': {'wins': 1, 'matches': 1, 'win_rate': 1.0}, 'Grass': {'wins': 0, 'matches': 0, 'win_rate': 0.0}}",1,2024-09-14
Tim Van Rijthoven,0,1,1,0.0,999,"{'Hard': {'wins': 0, 'matches': 0, 'win_rate': 0.0}, 'Clay': {'wins': 0, 'matches': 0, 'win_rate': 0.0}, 'Grass': {'wins': 0, 'matches': 1, 'win_rate': 0.0}}",0,2024-06-10
Aslan Karatsev,3,10,13,0.23076923076923078,139,"{'Hard': {'wins': 2, 'matches': 7, 'win_rate': 0.2857142857142857}, 'Clay': {'wins': 1, 'matches': 5, 'win_rate': 0.2}, 'Grass': {'wins': 0, 'matches': 1, 'win_rate': 0.0}}",3,2024-10-14
Alibek Kachmazov,3,1,4,0.75,252,"{'Hard': {'wins': 3, 'matches': 4, 'win_rate': 0.75}, 'Clay': {'wins': 0, 'matches': 0, 'win_rate': 0.0}, 'Grass': {'wins': 0, 'matches': 0, 'win_rate': 0.0}}",3,2024-09-18
Dalibor Svrcina,0,1,1,0.0,194,"{'Hard': {'wins': 0, 'matches': 1, 'win_rate': 0.0}, 'Clay': {'wins': 0, 'matches': 0, 'win_rate': 0.0}, 'Grass': {'wins': 0, 'matches': 0, 'win_rate': 0.0}}",0,2024-01-29
Hamza Karmoussi,0,1,1,0.0,999,"{'Hard': {'wins': 0, 'matches': 1, 'win_rate': 0.0}, 'Clay': {'wins': 0, 'matches': 0, 'win_rate': 0.0}, 'Grass': {'wins': 0, 'matches': 0, 'win_rate': 0.0}}",0,2024-02-03
Enzo Couacaud,0,1,1,0.0,205,"{'Hard': {'wins': 0, 'matches': 0, 'win_rate': 0.0}, 'Clay': {'wins': 0, 'matches': 1, 'win_rate': 0.0}, 'Grass': {'wins': 0, 'matches': 0, 'win_rate': 0.0}}",0,2024-07-22
Francesco Passaro,2,3,5,0.4,240,"{'Hard': {'wins': 0, 'matches': 0, 'win_rate': 0.0}, 'Clay': {'wins': 2, 'matches': 5, 'win_rate': 0.4}, 'Grass': {'wins': 0, 'matches': 0, 'win_rate': 0.0}}",2,2024-05-06
Alex Michelsen,34,30,64,0.53125,41,"{'Hard': {'wins': 26, 'matches': 45, 'win_rate': 0.5777777777777777}, 'Clay': {'wins': 3, 'matches': 9, 'win_rate': 0.3333333333333333}, 'Grass': {'wins': 5, 'matches': 10, 'win_rate': 0.5}}",7,2024-12-18
Arthur Fils,38,28,66,0.5757575757575758,20,"{'Hard': {'wins': 22, 'matches': 37, 'win_rate': 0.5945945945945946}, 'Clay': {'wins': 10, 'matches': 20, 'win_rate': 0.5}, 'Grass': {'wins': 6, 'matches': 9, 'win_rate': 0.6666666666666666}}",6,2024-12-18
Liova Ayite Ajavon,1,0,1,1.0,999,"{'Hard': {'wins': 1, 'matches': 1, 'win_rate': 1.0}, 'Clay': {'wins': 0, 'matches': 0, 'win_rate': 0.0}, 'Grass': {'wins': 0, 'matches': 0, 'win_rate': 0.0}}",1,2024-09-14
Cesar Cruz,0,1,1,0.0,999,"{'Hard': {'wins': 0, 'matches': 0, 'win_rate': 0.0}, 'Clay': {'wins': 0, 'matches': 1, 'win_rate': 0.0}, 'Grass': {'wins': 0, 'matches': 0, 'win_rate': 0.0}}",0,2024-09-14
Daniels Tens,0,2,2,0.0,999,"{'Hard': {'wins': 0, 'matches': 2, 'win_rate': 0.0}, 'Clay': {'wins': 0, 'matches': 0, 'win_rate': 0.0}, 'Grass': {'wins': 0, 'matches': 0, 'win_rate': 0.0}}",0,2024-09-14
Aleksandar Vukic,22,25,47,0.46808510638297873,85,"{'Hard': {'wins': 10, 'matches': 24, 'win_rate': 0.4166666666666667}, 'Clay': {'wins': 4, 'matches': 11, 'win_rate': 0.36363636363636365}, 'Grass': {'wins': 8, 'matches': 12, 'win_rate': 0.6666666666666666}}",6,2024-10-14
Nuno Borges,24,25,49,0.4897959183673469,33,"{'Hard': {'wins': 13, 'matches': 29, 'win_rate': 0.4482758620689655}, 'Clay': {'wins': 11, 'matches': 17, 'win_rate': 0.6470588235294118}, 'Grass': {'wins': 0, 'matches': 3, 'win_rate': 0.0}}",4,2024-11-04
Thanapet Chanta,0,1,1,0.0,938,"{'Hard': {'wins': 0, 'matches': 0, 'win_rate': 0.0}, 'Clay': {'wins': 0, 'matches': 1, 'win_rate': 0.0}, 'Grass': {'wins': 0, 'matches': 0, 'win_rate': 0.0}}",0,2024-02-03
Botic Van De Zandschulp,18,26,44,0.4090909090909091,80,"{'Hard': {'wins': 12, 'matches': 30, 'win_rate': 0.4}, 'Clay': {'wins': 5, 'matches': 11, 'win_rate': 0.45454545454545453}, 'Grass': {'wins': 1, 'matches': 3, 'win_rate': 0.3333333333333333}}",4,2024-11-24
Maxim Shin,0,1,1,0.0,1469,"{'Hard': {'wins': 0, 'matches': 1, 'win_rate': 0.0}, 'Clay': {'wins': 0, 'matches': 0, 'win_rate': 0.0}, 'Grass': {'wins': 0, 'matches': 0, 'win_rate': 0.0}}",0,2024-02-02
Mackenzie Mcdonald,5,13,18,0.2777777777777778,149,"{'Hard': {'wins': 2, 'matches': 9, 'win_rate': 0.2222222222222222}, 'Clay': {'wins': 0, 'matches': 3, 'win_rate': 0.0}, 'Grass': {'wins': 3, 'matches': 6, 'win_rate': 0.5}}",4,2024-09-13
Roberto Bautista Agut,25,21,46,0.5434782608695652,47,"{'Hard': {'wins': 14, 'matches': 27, 'win_rate': 0.5185185185185185}, 'Clay': {'wins': 5, 'matches': 10, 'win_rate': 0.5}, 'Grass': {'wins': 6, 'matches': 9, 'win_rate': 0.6666666666666666}}",7,2024-11-04
Stefanos Tsitsipas,45,22,67,0.6716417910447762,11,"{'Hard': {'wins': 21, 'matches': 35, 'win_rate': 0.6}, 'Clay': {'wins': 22, 'matches': 28, 'win_rate': 0.7857142857142857}, 'Grass': {'wins': 2, 'matches': 4, 'win_rate': 0.5}}",7,2024-10-28
Ilya Snitari,0,2,2,0.0,740,"{'Hard': {'wins': 0, 'matches': 0, 'win_rate': 0.0}, 'Clay': {'wins': 0, 'matches': 2, 'win_rate': 0.0}, 'Grass': {'wins': 0, 'matches': 0, 'win_rate': 0.0}}",0,2024-02-03
Mikhail Kukushkin,2,3,5,0.4,111,"{'Hard': {'wins': 2, 'matches': 4, 'win_rate': 0.5}, 'Clay': {'wins': 0, 'matches': 1, 'win_rate': 0.0}, 'Grass': {'wins': 0, 'matches': 0, 'win_rate': 0.0}}",2,2024-10-14
Komlavi Loglo,1,1,2,0.5,999,"{'Hard': {'wins': 1, 'matches': 2, 'win_rate': 0.5}, 'Clay': {'wins': 0, 'matches': 0, 'win_rate': 0.0}, 'Grass': {'wins': 0, 'matches': 0, 'win_rate': 0.0}}",1,2024-02-03
Roberto Carballes Baena,25,26,51,0.49019607843137253,56,"{'Hard': {'wins': 10, 'matches': 22, 'win_rate': 0.45454545454545453}, 'Clay': {'wins': 14, 'matches': 26, 'win_rate': 0.5384615384615384}, 'Grass': {'wins': 1, 'matches': 3, 'win_rate': 0.3333333333333333}}",5,2024-11-04
Jack Cheng,0,1,1,0.0,1600,"{'Hard': {'wins': 0, 'matches': 1, 'win_rate': 0.0}, 'Clay': {'wins': 0, 'matches': 0, 'win_rate': 0.0}, 'Grass': {'wins': 0, 'matches': 0, 'win_rate': 0.0}}",0,2024-09-14
Cezar Cretu,2,0,2,1.0,292,"{'Hard': {'wins': 2, 'matches': 2, 'win_rate': 1.0}, 'Clay': {'wins': 0, 'matches': 0, 'win_rate': 0.0}, 'Grass': {'wins': 0, 'matches': 0, 'win_rate': 0.0}}",2,2024-09-13
Sina Moghimi,1,1,2,0.5,1086,"{'Hard': {'wins': 0, 'matches': 0, 'win_rate': 0.0}, 'Clay': {'wins': 1, 'matches': 2, 'win_rate': 0.5}, 'Grass': {'wins': 0, 'matches': 0, 'win_rate': 0.0}}",1,2024-03-15
Osgar Ohoisin,0,1,1,0.0,1015,"{'Hard': {'wins': 0, 'matches': 1, 'win_rate': 0.0}, 'Clay': {'wins': 0, 'matches': 0, 'win_rate': 0.0}, 'Grass': {'wins': 0, 'matches': 0, 'win_rate': 0.0}}",0,2024-02-03
Mariano Navone,18,24,42,0.42857142857142855,45,"{'Hard': {'wins': 3, 'matches': 13, 'win_rate': 0.23076923076923078}, 'Clay': {'wins': 15, 'matches': 26, 'win_rate': 0.5769230769230769}, 'Grass': {'wins': 0, 'matches': 3, 'win_rate': 0.0}}",3,2024-11-04
Adrian Mannarino,16,31,47,0.3404255319148936,54,"{'Hard': {'wins': 15, 'matches': 37, 'win_rate': 0.40540540540540543}, 'Clay': {'wins': 0, 'matches': 4, 'win_rate': 0.0}, 'Grass': {'wins': 1, 'matches': 6, 'win_rate': 0.16666666666666666}}",4,2024-11-04
Luca Van Assche,10,19,29,0.3448275862068966,128,"{'Hard': {'wins': 8, 'matches': 20, 'win_rate': 0.4}, 'Clay': {'wins': 2, 'matches': 8, 'win_rate': 0.25}, 'Grass': {'wins': 0, 'matches': 1, 'win_rate': 0.0}}",3,2024-12-18
Sebastian Baez,31,28,59,0.5254237288135594,27,"{'Hard': {'wins': 5, 'matches': 19, 'win_rate': 0.2631578947368421}, 'Clay': {'wins': 26, 'matches': 37, 'win_rate': 0.7027027027027027}, 'Grass': {'wins': 0, 'matches': 3, 'win_rate': 0.0}}",2,2024-11-21
Carlos Taberner,0,1,1,0.0,352,"{'Hard': {'wins': 0, 'matches': 0, 'win_rate': 0.0}, 'Clay': {'wins': 0, 'matches': 1, 'win_rate': 0.0}, 'Grass': {'wins': 0, 'matches': 0, 'win_rate': 0.0}}",0,2024-04-15
James Mccabe,0,4,4,0.0,302,"{'Hard': {'wins': 0, 'matches': 3, 'win_rate': 0.0}, 'Clay': {'wins': 0, 'matches': 0, 'win_rate': 0.0}, 'Grass': {'wins': 0, 'matches': 1, 'win_rate': 0.0}}",0,2024-09-18
Alexander Zverev,69,21,90,0.7666666666666667,2,"{'Hard': {'wins': 40, 'matches': 53, 'win_rate': 0.7547169811320755}, 'Clay': {'wins': 23, 'matches': 29, 'win_rate': 0.7931034482758621}, 'Grass': {'wins': 6, 'matches': 8, 'win_rate': 0.75}}",9,2024-11-11
Anthony Susanto,0,2,2,0.0,999,"{'Hard': {'wins': 0, 'matches': 2, 'win_rate': 0.0}, 'Clay': {'wins': 0, 'matches': 0, 'win_rate': 0.0}, 'Grass': {'wins': 0, 'matches': 0, 'win_rate': 0.0}}",0,2024-02-03
Pablo Llamas Ruiz,3,3,6,0.5,146,"{'Hard': {'wins': 1, 'matches': 2, 'win_rate': 0.5}, 'Clay': {'wins': 2, 'matches': 4, 'win_rate': 0.5}, 'Grass': {'wins': 0, 'matches': 0, 'win_rate': 0.0}}",3,2024-04-22
Hugo Grenier,2,6,8,0.25,173,"{'Hard': {'wins': 2, 'matches': 7, 'win_rate': 0.2857142857142857}, 'Clay': {'wins': 0, 'matches': 1, 'win_rate': 0.0}, 'Grass': {'wins': 0, 'matches': 0, 'win_rate': 0.0}}",2,2024-08-26
Norbert Gombos,0,1,1,0.0,408,"{'Hard': {'wins': 0, 'matches': 1, 'win_rate': 0.0}, 'Clay': {'wins': 0, 'matches': 0, 'win_rate': 0.0}, 'Grass': {'wins': 0, 'matches': 0, 'win_rate': 0.0}}",0,2024-09-15
Tomas Martin Etcheverry,31,29,60,0.5166666666666667,39,"{'Hard': {'wins': 12, 'matches': 26, 'win_rate': 0.46153846153846156}, 'Clay': {'wins': 18, 'matches': 30, 'win_rate': 0.6}, 'Grass': {'wins': 1, 'matches': 4, 'win_rate': 0.25}}",4,2024-11-04
Stylianos Christodoulou,1,0,1,1.0,1114,"{'Hard': {'wins': 1, 'matches': 1, 'win_rate': 1.0}, 'Clay': {'wins': 0, 'matches': 0, 'win_rate': 0.0}, 'Grass': {'wins': 0, 'matches': 0, 'win_rate': 0.0}}",1,2024-02-03
Emil Ruusuvuori,16,14,30,0.5333333333333333,71,"{'Hard': {'wins': 12, 'matches': 20, 'win_rate': 0.6}, 'Clay': {'wins': 1, 'matches': 5, 'win_rate': 0.2}, 'Grass': {'wins': 3, 'matches': 5, 'win_rate': 0.6}}",5,2024-07-29
Zizou Bergs,17,18,35,0.4857142857142857,61,"{'Hard': {'wins': 13, 'matches': 23, 'win_rate': 0.5652173913043478}, 'Clay': {'wins': 3, 'matches': 9, 'win_rate': 0.3333333333333333}, 'Grass': {'wins': 1, 'matches': 3, 'win_rate': 0.3333333333333333}}",6,2024-11-04
Vladyslav Orlov,0,1,1,0.0,598,"{'Hard': {'wins': 0, 'matches': 1, 'win_rate': 0.0}, 'Clay': {'wins': 0, 'matches': 0, 'win_rate': 0.0}, 'Grass': {'wins': 0, 'matches': 0, 'win_rate': 0.0}}",0,2024-02-01
Karl Friberg,0,1,1,0.0,364,"{'Hard': {'wins': 0, 'matches': 1, 'win_rate': 0.0}, 'Clay': {'wins': 0, 'matches': 0, 'win_rate': 0.0}, 'Grass': {'wins': 0, 'matches': 0, 'win_rate': 0.0}}",0,2024-02-02
Alexei Popyrin,28,22,50,0.56,24,"{'Hard': {'wins': 21, 'matches': 32, 'win_rate': 0.65625}, 'Clay': {'wins': 4, 'matches': 12, 'win_rate': 0.3333333333333333}, 'Grass': {'wins': 3, 'matches': 6, 'win_rate': 0.5}}",5,2024-10-28
Camilo Ugo Carabelli,2,6,8,0.25,93,"{'Hard': {'wins': 0, 'matches': 2, 'win_rate': 0.0}, 'Clay': {'wins': 2, 'matches': 6, 'win_rate': 0.3333333333333333}, 'Grass': {'wins': 0, 'matches': 0, 'win_rate': 0.0}}",2,2024-08-26
Mitchell Krueger,2,4,6,0.3333333333333333,140,"{'Hard': {'wins': 2, 'matches': 6, 'win_rate': 0.3333333333333333}, 'Clay': {'wins': 0, 'matches': 0, 'win_rate': 0.0}, 'Grass': {'wins': 0, 'matches': 0, 'win_rate': 0.0}}",2,2024-09-18
Jiri Vesely,0,1,1,0.0,293,"{'Hard': {'wins': 0, 'matches': 1, 'win_rate': 0.0}, 'Clay': {'wins': 0, 'matches': 0, 'win_rate': 0.0}, 'Grass': {'wins': 0, 'matches': 0, 'win_rate': 0.0}}",0,2024-01-15
Patrick Kypson,3,4,7,0.42857142857142855,133,"{'Hard': {'wins': 3, 'matches': 6, 'win_rate': 0.5}, 'Clay': {'wins': 0, 'matches': 1, 'win_rate': 0.0}, 'Grass': {'wins': 0, 'matches': 0, 'win_rate': 0.0}}",3,2024-04-01
Joao Sousa,0,2,2,0.0,272,"{'Hard': {'wins': 0, 'matches': 1, 'win_rate': 0.0}, 'Clay': {'wins': 0, 'matches': 1, 'win_rate': 0.0}, 'Grass': {'wins': 0, 'matches': 0, 'win_rate': 0.0}}",0,2024-04-01
Jack Loutit,1,0,1,1.0,790,"{'Hard': {'wins': 1, 'matches': 1, 'win_rate': 1.0}, 'Clay': {'wins': 0, 'matches': 0, 'win_rate': 0.0}, 'Grass': {'wins': 0, 'matches': 0, 'win_rate': 0.0}}",1,2024-09-14
Dmitry Popko,0,2,2,0.0,338,"{'Hard': {'wins': 0, 'matches': 0, 'win_rate': 0.0}, 'Clay': {'wins': 0, 'matches': 2, 'win_rate': 0.0}, 'Grass': {'wins': 0, 'matches': 0, 'win_rate': 0.0}}",0,2024-02-03
Chris Rodesch,2,2,4,0.5,507,"{'Hard': {'wins': 1, 'matches': 2, 'win_rate': 0.5}, 'Clay': {'wins': 1, 'matches': 2, 'win_rate': 0.5}, 'Grass': {'wins': 0, 'matches': 0, 'win_rate': 0.0}}",2,2024-09-14
Leandro Riedi,2,2,4,0.5,134,"{'Hard': {'wins': 1, 'matches': 2, 'win_rate': 0.5}, 'Clay': {'wins': 1, 'matches': 2, 'win_rate': 0.5}, 'Grass': {'wins': 0, 'matches': 0, 'win_rate': 0.0}}",2,2024-07-15
Mark Lajal,1,2,3,0.3333333333333333,224,"{'Hard': {'wins': 1, 'matches': 2, 'win_rate': 0.5}, 'Clay': {'wins': 0, 'matches': 0, 'win_rate': 0.0}, 'Grass': {'wins': 0, 'matches': 1, 'win_rate': 0.0}}",1,2024-09-13
N Sriram Balaji,1,1,2,0.5,999,"{'Hard': {'wins': 0, 'matches': 1, 'win_rate': 0.0}, 'Clay': {'wins': 0, 'matches': 0, 'win_rate': 0.0}, 'Grass': {'wins': 1, 'matches': 1, 'win_rate': 1.0}}",1,2024-09-14
Iliyan Radulov,1,0,1,1.0,766,"{'Hard': {'wins': 0, 'matches': 0, 'win_rate': 0.0}, 'Clay': {'wins': 1, 'matches': 1, 'win_rate': 1.0}, 'Grass': {'wins': 0, 'matches': 0, 'win_rate': 0.0}}",1,2024-09-14
Pavel Kotov,18,23,41,0.43902439024390244,75,"{'Hard': {'wins': 7, 'matches': 20, 'win_rate': 0.35}, 'Clay': {'wins': 11, 'matches': 20, 'win_rate': 0.55}, 'Grass': {'wins': 0, 'matches': 1, 'win_rate': 0.0}}",3,2024-11-04
Federico Coria,8,15,23,0.34782608695652173,79,"{'Hard': {'wins': 0, 'matches': 3, 'win_rate': 0.0}, 'Clay': {'wins': 8, 'matches': 19, 'win_rate': 0.42105263157894735}, 'Grass': {'wins': 0, 'matches': 1, 'win_rate': 0.0}}",1,2024-08-26
Matteo Martineau,0,1,1,0.0,179,"{'Hard': {'wins': 0, 'matches': 0, 'win_rate': 0.0}, 'Clay': {'wins': 0, 'matches': 0, 'win_rate': 0.0}, 'Grass': {'wins': 0, 'matches': 1, 'win_rate': 0.0}}",0,2024-06-10
Matteo Berrettini,32,12,44,0.7272727272727273,35,"{'Hard': {'wins': 11, 'matches': 19, 'win_rate': 0.5789473684210527}, 'Clay': {'wins': 15, 'matches': 16, 'win_rate': 0.9375}, 'Grass': {'wins': 6, 'matches': 9, 'win_rate': 0.6666666666666666}}",6,2024-11-24
Quentin Halys,11,9,20,0.55,84,"{'Hard': {'wins': 5, 'matches': 12, 'win_rate': 0.4166666666666667}, 'Clay': {'wins': 4, 'matches': 5, 'win_rate': 0.8}, 'Grass': {'wins': 2, 'matches': 3, 'win_rate': 0.6666666666666666}}",4,2024-11-04
Benoit Paire,2,3,5,0.4,227,"{'Hard': {'wins': 1, 'matches': 2, 'win_rate': 0.5}, 'Clay': {'wins': 0, 'matches': 1, 'win_rate': 0.0}, 'Grass': {'wins': 1, 'matches': 2, 'win_rate': 0.5}}",2,2024-07-15
Franco Roncadelli,3,1,4,0.75,366,"{'Hard': {'wins': 0, 'matches': 0, 'win_rate': 0.0}, 'Clay': {'wins': 3, 'matches': 4, 'win_rate': 0.75}, 'Grass': {'wins': 0, 'matches': 0, 'win_rate': 0.0}}",3,2024-09-13
Cristian Garin,9,10,19,0.47368421052631576,115,"{'Hard': {'wins': 2, 'matches': 5, 'win_rate': 0.4}, 'Clay': {'wins': 7, 'matches': 13, 'win_rate': 0.5384615384615384}, 'Grass': {'wins': 0, 'matches': 1, 'win_rate': 0.0}}",5,2024-09-15
Min Kyu Song,0,1,1,0.0,999,"{'Hard': {'wins': 0, 'matches': 1, 'win_rate': 0.0}, 'Clay': {'wins': 0, 'matches': 0, 'win_rate': 0.0}, 'Grass': {'wins': 0, 'matches': 0, 'win_rate': 0.0}}",0,2024-09-13
Conor Gannon,0,2,2,0.0,1294,"{'Hard': {'wins': 0, 'matches': 0, 'win_rate': 0.0}, 'Clay': {'wins': 0, 'matches': 2, 'win_rate': 0.0}, 'Grass': {'wins': 0, 'matches': 0, 'win_rate': 0.0}}",0,2024-09-13
Andres Martin,0,1,1,0.0,483,"{'Hard': {'wins': 0, 'matches': 1, 'win_rate': 0.0}, 'Clay': {'wins': 0, 'matches': 0, 'win_rate': 0.0}, 'Grass': {'wins': 0, 'matches': 0, 'win_rate': 0.0}}",0,2024-07-22
Li Tu,0,4,4,0.0,191,"{'Hard': {'wins': 0, 'matches': 3, 'win_rate': 0.0}, 'Clay': {'wins': 0, 'matches': 0, 'win_rate': 0.0}, 'Grass': {'wins': 0, 'matches': 1, 'win_rate': 0.0}}",0,2024-10-02
Darwin Blanch,0,2,2,0.0,1028,"{'Hard': {'wins': 0, 'matches': 1, 'win_rate': 0.0}, 'Clay': {'wins': 0, 'matches': 1, 'win_rate': 0.0}, 'Grass': {'wins': 0, 'matches': 0, 'win_rate': 0.0}}",0,2024-04-22
Mate Valkusz,1,3,4,0.25,402,"{'Hard': {'wins': 0, 'matches': 2, 'win_rate': 0.0}, 'Clay': {'wins': 1, 'matches': 2, 'win_rate': 0.5}, 'Grass': {'wins': 0, 'matches': 0, 'win_rate': 0.0}}",1,2024-09-13
Alexander Shevchenko,22,28,50,0.44,64,"{'Hard': {'wins': 15, 'matches': 32, 'win_rate': 0.46875}, 'Clay': {'wins': 6, 'matches': 15, 'win_rate': 0.4}, 'Grass': {'wins': 1, 'matches': 3, 'win_rate': 0.3333333333333333}}",5,2024-11-04
Aqeel Khan,1,1,2,0.5,999,"{'Hard': {'wins': 1, 'matches': 1, 'win_rate': 1.0}, 'Clay': {'wins': 0, 'matches': 0, 'win_rate': 0.0}, 'Grass': {'wins': 0, 'matches': 1, 'win_rate': 0.0}}",1,2024-09-14
Marcelo Arevalo,2,1,3,0.6666666666666666,999,"{'Hard': {'wins': 1, 'matches': 1, 'win_rate': 1.0}, 'Clay': {'wins': 1, 'matches': 2, 'win_rate': 0.5}, 'Grass': {'wins': 0, 'matches': 0, 'win_rate': 0.0}}",2,2024-09-14
Elias Ymer,3,5,8,0.375,252,"{'Hard': {'wins': 3, 'matches': 6, 'win_rate': 0.5}, 'Clay': {'wins': 0, 'matches': 1, 'win_rate': 0.0}, 'Grass': {'wins': 0, 'matches': 1, 'win_rate': 0.0}}",3,2024-10-14
Nicolas Mejia,1,4,5,0.2,237,"{'Hard': {'wins': 0, 'matches': 3, 'win_rate': 0.0}, 'Clay': {'wins': 1, 'matches': 2, 'win_rate': 0.5}, 'Grass': {'wins': 0, 'matches': 0, 'win_rate': 0.0}}",1,2024-09-14
Titouan Droguet,0,2,2,0.0,174,"{'Hard': {'wins': 0, 'matches': 1, 'win_rate': 0.0}, 'Clay': {'wins': 0, 'matches': 1, 'win_rate': 0.0}, 'Grass': {'wins': 0, 'matches': 0, 'win_rate': 0.0}}",0,2024-11-04
Petros Tsitsipas,0,1,1,0.0,999,"{'Hard': {'wins': 0, 'matches': 0, 'win_rate': 0.0}, 'Clay': {'wins': 0, 'matches': 1, 'win_rate': 0.0}, 'Grass': {'wins': 0, 'matches': 0, 'win_rate': 0.0}}",0,2024-07-29
Jaume Munar,13,24,37,0.35135135135135137,65,"{'Hard': {'wins': 2, 'matches': 11, 'win_rate': 0.18181818181818182}, 'Clay': {'wins': 10, 'matches': 23, 'win_rate': 0.43478260869565216}, 'Grass': {'wins': 1, 'matches': 3, 'win_rate': 0.3333333333333333}}",1,2024-10-14
Ramkumar Ramanathan,1,2,3,0.3333333333333333,332,"{'Hard': {'wins': 0, 'matches': 2, 'win_rate': 0.0}, 'Clay': {'wins': 0, 'matches': 0, 'win_rate': 0.0}, 'Grass': {'wins': 1, 'matches': 1, 'win_rate': 1.0}}",1,2024-10-02
Hugo Dellien,2,4,6,0.3333333333333333,106,"{'Hard': {'wins': 0, 'matches': 0, 'win_rate': 0.0}, 'Clay': {'wins': 2, 'matches': 6, 'win_rate': 0.3333333333333333}, 'Grass': {'wins': 0, 'matches': 0, 'win_rate': 0.0}}",2,2024-09-13
Martin Landaluce,1,3,4,0.25,322,"{'Hard': {'wins': 1, 'matches': 2, 'win_rate': 0.5}, 'Clay': {'wins': 0, 'matches': 2, 'win_rate': 0.0}, 'Grass': {'wins': 0, 'matches': 0, 'win_rate': 0.0}}",1,2024-04-22
James Duckworth,9,15,24,0.375,77,"{'Hard': {'wins': 5, 'matches': 16, 'win_rate': 0.3125}, 'Clay': {'wins': 1, 'matches': 2, 'win_rate': 0.5}, 'Grass': {'wins': 3, 'matches': 6, 'win_rate': 0.5}}",1,2024-11-04
Denis Shapovalov,26,23,49,0.5306122448979592,56,"{'Hard': {'wins': 18, 'matches': 33, 'win_rate': 0.5454545454545454}, 'Clay': {'wins': 5, 'matches': 11, 'win_rate': 0.45454545454545453}, 'Grass': {'wins': 3, 'matches': 5, 'win_rate': 0.6}}",7,2024-11-20
Alex Knaff,3,1,4,0.75,644,"{'Hard': {'wins': 2, 'matches': 2, 'win_rate': 1.0}, 'Clay': {'wins': 1, 'matches': 2, 'win_rate': 0.5}, 'Grass': {'wins': 0, 'matches': 0, 'win_rate': 0.0}}",3,2024-09-14
Matthew Forbes,0,1,1,0.0,1848,"{'Hard': {'wins': 0, 'matches': 1, 'win_rate': 0.0}, 'Clay': {'wins': 0, 'matches': 0, 'win_rate': 0.0}, 'Grass': {'wins': 0, 'matches': 0, 'win_rate': 0.0}}",0,2024-08-26
Constant Lestienne,3,12,15,0.2,111,"{'Hard': {'wins': 3, 'matches': 11, 'win_rate': 0.2727272727272727}, 'Clay': {'wins': 0, 'matches': 1, 'win_rate': 0.0}, 'Grass': {'wins': 0, 'matches': 3, 'win_rate': 0.0}}",2,2024-08-26
Tristan Schoolkate,1,3,4,0.25,193,"{'Hard': {'wins': 1, 'matches': 3, 'win_rate': 0.3333333333333333}, 'Clay': {'wins': 0, 'matches': 0, 'win_rate': 0.0}, 'Grass': {'wins': 0, 'matches': 1, 'win_rate': 0.0}}",1,2024-08-26
Fabio Fognini,12,14,26,0.46153846153846156,74,"{'Hard': {'wins': 2, 'matches': 9, 'win_rate': 0.2222222222222222}, 'Clay': {'wins': 7, 'matches': 12, 'win_rate': 0.5833333333333334}, 'Grass': {'wins': 3, 'matches': 5, 'win_rate': 0.6}}",3,2024-11-04
Muhammad Shoaib,0,2,2,0.0,999,"{'Hard': {'wins': 0, 'matches': 1, 'win_rate': 0.0}, 'Clay': {'wins': 0, 'matches': 0, 'win_rate': 0.0}, 'Grass': {'wins': 0, 'matches': 1, 'win_rate': 0.0}}",0,2024-09-14
Federico Agustin Gomez,1,2,3,0.3333333333333333,174,"{'Hard': {'wins': 1, 'matches': 2, 'win_rate': 0.5}, 'Clay': {'wins': 0, 'matches': 1, 'win_rate': 0.0}, 'Grass': {'wins': 0, 'matches': 0, 'win_rate': 0.0}}",1,2024-09-18
Mattia Bellucci,6,8,14,0.42857142857142855,101,"{'Hard': {'wins': 6, 'matches': 12, 'win_rate': 0.5}, 'Clay': {'wins': 0, 'matches': 1, 'win_rate': 0.0}, 'Grass': {'wins': 0, 'matches': 1, 'win_rate': 0.0}}",5,2024-10-02
Denis Kudla,1,3,4,0.25,160,"{'Hard': {'wins': 1, 'matches': 3, 'win_rate': 0.3333333333333333}, 'Clay': {'wins': 0, 'matches': 1, 'win_rate': 0.0}, 'Grass': {'wins': 0, 'matches': 0, 'win_rate': 0.0}}",1,2024-04-01
Taro Daniel,10,24,34,0.29411764705882354,89,"{'Hard': {'wins': 8, 'matches': 23, 'win_rate': 0.34782608695652173}, 'Clay': {'wins': 2, 'matches': 8, 'win_rate': 0.25}, 'Grass': {'wins': 0, 'matches': 3, 'win_rate': 0.0}}",2,2024-10-14
Joaquin  Aguilar Cardozo ,1,2,3,0.3333333333333333,851,"{'Hard': {'wins': 0, 'matches': 0, 'win_rate': 0.0}, 'Clay': {'wins': 1, 'matches': 3, 'win_rate': 0.3333333333333333}, 'Grass': {'wins': 0, 'matches': 0, 'win_rate': 0.0}}",1,2024-09-13
Shintaro Mochizuki,0,7,7,0.0,146,"{'Hard': {'wins': 0, 'matches': 5, 'win_rate': 0.0}, 'Clay': {'wins': 0, 'matches': 1, 'win_rate': 0.0}, 'Grass': {'wins': 0, 'matches': 1, 'win_rate': 0.0}}",0,2024-09-25
Jan Lennard Struff,31,22,53,0.5849056603773585,43,"{'Hard': {'wins': 9, 'matches': 23, 'win_rate': 0.391304347826087}, 'Clay': {'wins': 16, 'matches': 21, 'win_rate': 0.7619047619047619}, 'Grass': {'wins': 6, 'matches': 9, 'win_rate': 0.6666666666666666}}",4,2024-11-22
Davis Rolis,0,2,2,0.0,999,"{'Hard': {'wins': 0, 'matches': 2, 'win_rate': 0.0}, 'Clay': {'wins': 0, 'matches': 0, 'win_rate': 0.0}, 'Grass': {'wins': 0, 'matches': 0, 'win_rate': 0.0}}",0,2024-09-14
Courtney John Lock,0,1,1,0.0,999,"{'Hard': {'wins': 0, 'matches': 1, 'win_rate': 0.0}, 'Clay': {'wins': 0, 'matches': 0, 'win_rate': 0.0}, 'Grass': {'wins': 0, 'matches': 0, 'win_rate': 0.0}}",0,2024-02-03
Juan Manuel Cerundolo,1,2,3,0.3333333333333333,161,"{'Hard': {'wins': 0, 'matches': 0, 'win_rate': 0.0}, 'Clay': {'wins': 1, 'matches': 3, 'win_rate': 0.3333333333333333}, 'Grass': {'wins': 0, 'matches': 0, 'win_rate': 0.0}}",1,2024-02-26
Wishaya Trongcharoenchaikul,0,1,1,0.0,780,"{'Hard': {'wins': 0, 'matches': 0, 'win_rate': 0.0}, 'Clay': {'wins': 0, 'matches': 1, 'win_rate': 0.0}, 'Grass': {'wins': 0, 'matches': 0, 'win_rate': 0.0}}",0,2024-02-03
Novak Djokovic,38,10,48,0.7916666666666666,4,"{'Hard': {'wins': 16, 'matches': 21, 'win_rate': 0.7619047619047619}, 'Clay': {'wins': 16, 'matches': 20, 'win_rate': 0.8}, 'Grass': {'wins': 6, 'matches': 7, 'win_rate': 0.8571428571428571}}",8,2024-10-02
Damir Dzumhur,2,4,6,0.3333333333333333,100,"{'Hard': {'wins': 2, 'matches': 6, 'win_rate': 0.3333333333333333}, 'Clay': {'wins': 0, 'matches': 0, 'win_rate': 0.0}, 'Grass': {'wins': 0, 'matches': 0, 'win_rate': 0.0}}",2,2024-10-14
Alexander Ritschard,0,1,1,0.0,194,"{'Hard': {'wins': 0, 'matches': 0, 'win_rate': 0.0}, 'Clay': {'wins': 0, 'matches': 1, 'win_rate': 0.0}, 'Grass': {'wins': 0, 'matches': 0, 'win_rate': 0.0}}",0,2024-04-01
Michael Mmoh,5,4,9,0.5555555555555556,123,"{'Hard': {'wins': 3, 'matches': 6, 'win_rate': 0.5}, 'Clay': {'wins': 2, 'matches': 3, 'win_rate': 0.6666666666666666}, 'Grass': {'wins': 0, 'matches': 0, 'win_rate': 0.0}}",5,2024-04-01
Matteo Arnaldi,28,25,53,0.5283018867924528,38,"{'Hard': {'wins': 18, 'matches': 33, 'win_rate': 0.5454545454545454}, 'Clay': {'wins': 9, 'matches': 17, 'win_rate': 0.5294117647058824}, 'Grass': {'wins': 1, 'matches': 3, 'win_rate': 0.3333333333333333}}",4,2024-10-28
Stefanos Sakellaridis,0,1,1,0.0,416,"{'Hard': {'wins': 0, 'matches': 1, 'win_rate': 0.0}, 'Clay': {'wins': 0, 'matches': 0, 'win_rate': 0.0}, 'Grass': {'wins': 0, 'matches': 0, 'win_rate': 0.0}}",0,2024-01-01
Christopher Oconnell,17,22,39,0.4358974358974359,71,"{'Hard': {'wins': 17, 'matches': 34, 'win_rate': 0.5}, 'Clay': {'wins': 0, 'matches': 4, 'win_rate': 0.0}, 'Grass': {'wins': 0, 'matches': 1, 'win_rate': 0.0}}",4,2024-11-04
Martin Antonio Vergara Del Puerto,0,1,1,0.0,999,"{'Hard': {'wins': 0, 'matches': 0, 'win_rate': 0.0}, 'Clay': {'wins': 0, 'matches': 1, 'win_rate': 0.0}, 'Grass': {'wins': 0, 'matches': 0, 'win_rate': 0.0}}",0,2024-02-03
Rinky Hijikata,16,22,38,0.42105263157894735,78,"{'Hard': {'wins': 12, 'matches': 24, 'win_rate': 0.5}, 'Clay': {'wins': 1, 'matches': 6, 'win_rate': 0.16666666666666666}, 'Grass': {'wins': 3, 'matches': 8, 'win_rate': 0.375}}",5,2024-10-02
Marko Topo,0,1,1,0.0,320,"{'Hard': {'wins': 0, 'matches': 0, 'win_rate': 0.0}, 'Clay': {'wins': 0, 'matches': 1, 'win_rate': 0.0}, 'Grass': {'wins': 0, 'matches': 0, 'win_rate': 0.0}}",0,2024-04-15
Faris Zakaryia,0,1,1,0.0,923,"{'Hard': {'wins': 0, 'matches': 0, 'win_rate': 0.0}, 'Clay': {'wins': 0, 'matches': 1, 'win_rate': 0.0}, 'Grass': {'wins': 0, 'matches': 0, 'win_rate': 0.0}}",0,2024-09-13
Stan Wawrinka,10,17,27,0.37037037037037035,148,"{'Hard': {'wins': 5, 'matches': 13, 'win_rate': 0.38461538461538464}, 'Clay': {'wins': 4, 'matches': 12, 'win_rate': 0.3333333333333333}, 'Grass': {'wins': 1, 'matches': 2, 'win_rate': 0.5}}",5,2024-11-04
Aristotelis Thanos,1,1,2,0.5,713,"{'Hard': {'wins': 1, 'matches': 2, 'win_rate': 0.5}, 'Clay': {'wins': 0, 'matches': 0, 'win_rate': 0.0}, 'Grass': {'wins': 0, 'matches': 0, 'win_rate': 0.0}}",1,2024-09-14
Arthur Fery,0,1,1,0.0,247,"{'Hard': {'wins': 0, 'matches': 0, 'win_rate': 0.0}, 'Clay': {'wins': 0, 'matches': 0, 'win_rate': 0.0}, 'Grass': {'wins': 0, 'matches': 1, 'win_rate': 0.0}}",0,2024-07-01
Terence Atmane,3,7,10,0.3,161,"{'Hard': {'wins': 1, 'matches': 6, 'win_rate': 0.16666666666666666}, 'Clay': {'wins': 2, 'matches': 4, 'win_rate': 0.5}, 'Grass': {'wins': 0, 'matches': 0, 'win_rate': 0.0}}",3,2024-10-02
Laslo Djere,10,17,27,0.37037037037037035,141,"{'Hard': {'wins': 6, 'matches': 13, 'win_rate': 0.46153846153846156}, 'Clay': {'wins': 4, 'matches': 12, 'win_rate': 0.3333333333333333}, 'Grass': {'wins': 0, 'matches': 2, 'win_rate': 0.0}}",6,2024-11-04
Daniel Cukierman,1,1,2,0.5,508,"{'Hard': {'wins': 1, 'matches': 2, 'win_rate': 0.5}, 'Clay': {'wins': 0, 'matches': 0, 'win_rate': 0.0}, 'Grass': {'wins': 0, 'matches': 0, 'win_rate': 0.0}}",1,2024-09-13
Lukas Klein,9,11,20,0.45,153,"{'Hard': {'wins': 6, 'matches': 14, 'win_rate': 0.42857142857142855}, 'Clay': {'wins': 3, 'matches': 6, 'win_rate': 0.5}, 'Grass': {'wins': 0, 'matches': 0, 'win_rate': 0.0}}",4,2024-11-04
Maxime Janvier,0,1,1,0.0,225,"{'Hard': {'wins': 0, 'matches': 0, 'win_rate': 0.0}, 'Clay': {'wins': 0, 'matches': 0, 'win_rate': 0.0}, 'Grass': {'wins': 0, 'matches': 1, 'win_rate': 0.0}}",0,2024-07-01
Marcos Giron,27,26,53,0.5094339622641509,49,"{'Hard': {'wins': 15, 'matches': 30, 'win_rate': 0.5}, 'Clay': {'wins': 3, 'matches': 10, 'win_rate': 0.3}, 'Grass': {'wins': 9, 'matches': 13, 'win_rate': 0.6923076923076923}}",7,2024-10-28
Gilles Arnaud Bailly,0,1,1,0.0,869,"{'Hard': {'wins': 0, 'matches': 1, 'win_rate': 0.0}, 'Clay': {'wins': 0, 'matches': 0, 'win_rate': 0.0}, 'Grass': {'wins': 0, 'matches': 0, 'win_rate': 0.0}}",0,2024-10-14
Luka Mikrut,0,1,1,0.0,350,"{'Hard': {'wins': 0, 'matches': 0, 'win_rate': 0.0}, 'Clay': {'wins': 0, 'matches': 1, 'win_rate': 0.0}, 'Grass': {'wins': 0, 'matches': 0, 'win_rate': 0.0}}",0,2024-07-22
Richard Gasquet,4,14,18,0.2222222222222222,133,"{'Hard': {'wins': 2, 'matches': 10, 'win_rate': 0.2}, 'Clay': {'wins': 2, 'matches': 7, 'win_rate': 0.2857142857142857}, 'Grass': {'wins': 0, 'matches': 1, 'win_rate': 0.0}}",2,2024-11-04
Jesper De Jong,2,5,7,0.2857142857142857,109,"{'Hard': {'wins': 1, 'matches': 4, 'win_rate': 0.25}, 'Clay': {'wins': 1, 'matches': 3, 'win_rate': 0.3333333333333333}, 'Grass': {'wins': 0, 'matches': 0, 'win_rate': 0.0}}",2,2024-11-04
Marton Fucsovics,13,17,30,0.43333333333333335,91,"{'Hard': {'wins': 6, 'matches': 17, 'win_rate': 0.35294117647058826}, 'Clay': {'wins': 7, 'matches': 12, 'win_rate': 0.5833333333333334}, 'Grass': {'wins': 0, 'matches': 1, 'win_rate': 0.0}}",2,2024-11-04
Henri Squire,1,4,5,0.2,187,"{'Hard': {'wins': 0, 'matches': 1, 'win_rate': 0.0}, 'Clay': {'wins': 1, 'matches': 2, 'win_rate': 0.5}, 'Grass': {'wins': 0, 'matches': 2, 'win_rate': 0.0}}",1,2024-09-14
Gijs Brouwer,2,3,5,0.4,190,"{'Hard': {'wins': 0, 'matches': 0, 'win_rate': 0.0}, 'Clay': {'wins': 0, 'matches': 1, 'win_rate': 0.0}, 'Grass': {'wins': 2, 'matches': 4, 'win_rate': 0.5}}",2,2024-06-24
Gustavo Heide,2,5,7,0.2857142857142857,155,"{'Hard': {'wins': 0, 'matches': 1, 'win_rate': 0.0}, 'Clay': {'wins': 2, 'matches': 6, 'win_rate': 0.3333333333333333}, 'Grass': {'wins': 0, 'matches': 0, 'win_rate': 0.0}}",2,2024-07-22
Ugo Blanchet,1,2,3,0.3333333333333333,161,"{'Hard': {'wins': 0, 'matches': 1, 'win_rate': 0.0}, 'Clay': {'wins': 1, 'matches': 2, 'win_rate': 0.5}, 'Grass': {'wins': 0, 'matches': 0, 'win_rate': 0.0}}",1,2024-07-15
Marcos Lee Chan Baratau,0,1,1,0.0,1320,"{'Hard': {'wins': 0, 'matches': 1, 'win_rate': 0.0}, 'Clay': {'wins': 0, 'matches': 0, 'win_rate': 0.0}, 'Grass': {'wins': 0, 'matches': 0, 'win_rate': 0.0}}",0,2024-09-14
Vitaliy Sachko,0,2,2,0.0,386,"{'Hard': {'wins': 0, 'matches': 2, 'win_rate': 0.0}, 'Clay': {'wins': 0, 'matches': 0, 'win_rate': 0.0}, 'Grass': {'wins': 0, 'matches': 0, 'win_rate': 0.0}}",0,2024-09-13
Maximilian Marterer,6,17,23,0.2608695652173913,114,"{'Hard': {'wins': 3, 'matches': 12, 'win_rate': 0.25}, 'Clay': {'wins': 3, 'matches': 9, 'win_rate': 0.3333333333333333}, 'Grass': {'wins': 0, 'matches': 2, 'win_rate': 0.0}}",5,2024-10-14
Kei Nishikori,8,9,17,0.47058823529411764,141,"{'Hard': {'wins': 7, 'matches': 13, 'win_rate': 0.5384615384615384}, 'Clay': {'wins': 1, 'matches': 3, 'win_rate': 0.3333333333333333}, 'Grass': {'wins': 0, 'matches': 1, 'win_rate': 0.0}}",5,2024-10-21
Giles Hussey,1,1,2,0.5,359,"{'Hard': {'wins': 0, 'matches': 0, 'win_rate': 0.0}, 'Clay': {'wins': 0, 'matches': 0, 'win_rate': 0.0}, 'Grass': {'wins': 1, 'matches': 2, 'win_rate': 0.5}}",1,2024-06-24
Marius Copil,0,1,1,0.0,283,"{'Hard': {'wins': 0, 'matches': 1, 'win_rate': 0.0}, 'Clay': {'wins': 0, 'matches': 0, 'win_rate': 0.0}, 'Grass': {'wins': 0, 'matches': 0, 'win_rate': 0.0}}",0,2024-02-03
Alexey Vatutin,0,1,1,0.0,336,"{'Hard': {'wins': 0, 'matches': 1, 'win_rate': 0.0}, 'Clay': {'wins': 0, 'matches': 0, 'win_rate': 0.0}, 'Grass': {'wins': 0, 'matches': 0, 'win_rate': 0.0}}",0,2024-10-14
Yanki Erel,1,1,2,0.5,536,"{'Hard': {'wins': 1, 'matches': 1, 'win_rate': 1.0}, 'Clay': {'wins': 0, 'matches': 1, 'win_rate': 0.0}, 'Grass': {'wins': 0, 'matches': 0, 'win_rate': 0.0}}",1,2024-09-13
Kristjan Tamm,0,2,2,0.0,978,"{'Hard': {'wins': 0, 'matches': 1, 'win_rate': 0.0}, 'Clay': {'wins': 0, 'matches': 1, 'win_rate': 0.0}, 'Grass': {'wins': 0, 'matches': 0, 'win_rate': 0.0}}",0,2024-09-13
Dane Sweeny,0,1,1,0.0,257,"{'Hard': {'wins': 0, 'matches': 1, 'win_rate': 0.0}, 'Clay': {'wins': 0, 'matches': 0, 'win_rate': 0.0}, 'Grass': {'wins': 0, 'matches': 0, 'win_rate': 0.0}}",0,2024-01-15
Felix Auger Aliassime,33,25,58,0.5689655172413793,19,"{'Hard': {'wins': 15, 'matches': 30, 'win_rate': 0.5}, 'Clay': {'wins': 18, 'matches': 26, 'win_rate': 0.6923076923076923}, 'Grass': {'wins': 0, 'matches': 2, 'win_rate': 0.0}}",5,2024-10-21
Ugo Humbert,39,25,64,0.609375,18,"{'Hard': {'wins': 29, 'matches': 43, 'win_rate': 0.6744186046511628}, 'Clay': {'wins': 5, 'matches': 12, 'win_rate': 0.4166666666666667}, 'Grass': {'wins': 5, 'matches': 9, 'win_rate': 0.5555555555555556}}",7,2024-10-28
Paul Jubb,3,2,5,0.6,201,"{'Hard': {'wins': 0, 'matches': 0, 'win_rate': 0.0}, 'Clay': {'wins': 0, 'matches': 0, 'win_rate': 0.0}, 'Grass': {'wins': 3, 'matches': 5, 'win_rate': 0.6}}",3,2024-07-01
Lucas Miedler,1,0,1,1.0,1071,"{'Hard': {'wins': 1, 'matches': 1, 'win_rate': 1.0}, 'Clay': {'wins': 0, 'matches': 0, 'win_rate': 0.0}, 'Grass': {'wins': 0, 'matches': 0, 'win_rate': 0.0}}",1,2024-02-03
Yousaf Khalil,0,1,1,0.0,999,"{'Hard': {'wins': 0, 'matches': 1, 'win_rate': 0.0}, 'Clay': {'wins': 0, 'matches': 0, 'win_rate': 0.0}, 'Grass': {'wins': 0, 'matches': 0, 'win_rate': 0.0}}",0,2024-09-14
Fajing Sun,0,1,1,0.0,359,"{'Hard': {'wins': 0, 'matches': 1, 'win_rate': 0.0}, 'Clay': {'wins': 0, 'matches': 0, 'win_rate': 0.0}, 'Grass': {'wins': 0, 'matches': 0, 'win_rate': 0.0}}",0,2024-09-18
Hugo Gaston,13,16,29,0.4482758620689655,81,"{'Hard': {'wins': 6, 'matches': 15, 'win_rate': 0.4}, 'Clay': {'wins': 7, 'matches': 13, 'win_rate': 0.5384615384615384}, 'Grass': {'wins': 0, 'matches': 1, 'win_rate': 0.0}}",4,2024-11-04
Jozef Kovalik,3,4,7,0.42857142857142855,113,"{'Hard': {'wins': 1, 'matches': 3, 'win_rate': 0.3333333333333333}, 'Clay': {'wins': 2, 'matches': 4, 'win_rate': 0.5}, 'Grass': {'wins': 0, 'matches': 0, 'win_rate': 0.0}}",3,2024-09-15
Tomas Machac,33,24,57,0.5789473684210527,25,"{'Hard': {'wins': 23, 'matches': 39, 'win_rate': 0.5897435897435898}, 'Clay': {'wins': 9, 'matches': 15, 'win_rate': 0.6}, 'Grass': {'wins': 1, 'matches': 3, 'win_rate': 0.3333333333333333}}",7,2024-10-28
Nicolai Budkov Kjaer,2,0,2,1.0,737,"{'Hard': {'wins': 2, 'matches': 2, 'win_rate': 1.0}, 'Clay': {'wins': 0, 'matches': 0, 'win_rate': 0.0}, 'Grass': {'wins': 0, 'matches': 0, 'win_rate': 0.0}}",2,2024-09-13
Christopher Eubanks,11,19,30,0.36666666666666664,106,"{'Hard': {'wins': 7, 'matches': 15, 'win_rate': 0.4666666666666667}, 'Clay': {'wins': 0, 'matches': 6, 'win_rate': 0.0}, 'Grass': {'wins': 4, 'matches': 9, 'win_rate': 0.4444444444444444}}",5,2024-08-26
Maks Kasnikowski,1,2,3,0.3333333333333333,173,"{'Hard': {'wins': 1, 'matches': 3, 'win_rate': 0.3333333333333333}, 'Clay': {'wins': 0, 'matches': 0, 'win_rate': 0.0}, 'Grass': {'wins': 0, 'matches': 0, 'win_rate': 0.0}}",1,2024-09-13
Branko Djuric,0,1,1,0.0,781,"{'Hard': {'wins': 0, 'matches': 1, 'win_rate': 0.0}, 'Clay': {'wins': 0, 'matches': 0, 'win_rate': 0.0}, 'Grass': {'wins': 0, 'matches': 0, 'win_rate': 0.0}}",0,2024-11-04
Dusan Lajovic,17,19,36,0.4722222222222222,86,"{'Hard': {'wins': 4, 'matches': 12, 'win_rate': 0.3333333333333333}, 'Clay': {'wins': 13, 'matches': 23, 'win_rate': 0.5652173913043478}, 'Grass': {'wins': 0, 'matches': 1, 'win_rate': 0.0}}",4,2024-11-04
Yoshihito Nishioka,20,19,39,0.5128205128205128,60,"{'Hard': {'wins': 13, 'matches': 25, 'win_rate': 0.52}, 'Clay': {'wins': 4, 'matches': 9, 'win_rate': 0.4444444444444444}, 'Grass': {'wins': 3, 'matches': 5, 'win_rate': 0.6}}",5,2024-10-02
Eliot Spizzirri,1,2,3,0.3333333333333333,341,"{'Hard': {'wins': 0, 'matches': 1, 'win_rate': 0.0}, 'Clay': {'wins': 0, 'matches': 0, 'win_rate': 0.0}, 'Grass': {'wins': 1, 'matches': 2, 'win_rate': 0.5}}",1,2024-08-26
Amr Elsayed Abdou Ahmed Mohamed,1,1,2,0.5,643,"{'Hard': {'wins': 0, 'matches': 0, 'win_rate': 0.0}, 'Clay': {'wins': 1, 'matches': 2, 'win_rate': 0.5}, 'Grass': {'wins': 0, 'matches': 0, 'win_rate': 0.0}}",1,2024-09-13
Francisco Comesana,4,7,11,0.36363636363636365,108,"{'Hard': {'wins': 2, 'matches': 4, 'win_rate': 0.5}, 'Clay': {'wins': 0, 'matches': 4, 'win_rate': 0.0}, 'Grass': {'wins': 2, 'matches': 3, 'win_rate': 0.6666666666666666}}",4,2024-08-26
Arthur Rinderknech,21,23,44,0.4772727272727273,60,"{'Hard': {'wins': 14, 'matches': 27, 'win_rate': 0.5185185185185185}, 'Clay': {'wins': 4, 'matches': 10, 'win_rate': 0.4}, 'Grass': {'wins': 3, 'matches': 7, 'win_rate': 0.42857142857142855}}",4,2024-10-28
Facundo Diaz Acosta,16,17,33,0.48484848484848486,67,"{'Hard': {'wins': 1, 'matches': 8, 'win_rate': 0.125}, 'Clay': {'wins': 15, 'matches': 24, 'win_rate': 0.625}, 'Grass': {'wins': 0, 'matches': 1, 'win_rate': 0.0}}",4,2024-10-14
Gillian Osmont,0,1,1,0.0,999,"{'Hard': {'wins': 0, 'matches': 1, 'win_rate': 0.0}, 'Clay': {'wins': 0, 'matches': 0, 'win_rate': 0.0}, 'Grass': {'wins': 0, 'matches': 0, 'win_rate': 0.0}}",0,2024-02-02
Jurij Rodionov,2,3,5,0.4,170,"{'Hard': {'wins': 0, 'matches': 1, 'win_rate': 0.0}, 'Clay': {'wins': 2, 'matches': 4, 'win_rate': 0.5}, 'Grass': {'wins': 0, 'matches': 0, 'win_rate': 0.0}}",2,2024-09-13
Billy Harris,7,6,13,0.5384615384615384,106,"{'Hard': {'wins': 1, 'matches': 3, 'win_rate': 0.3333333333333333}, 'Clay': {'wins': 0, 'matches': 0, 'win_rate': 0.0}, 'Grass': {'wins': 6, 'matches': 10, 'win_rate': 0.6}}",5,2024-10-02
Brandon Holt,0,2,2,0.0,227,"{'Hard': {'wins': 0, 'matches': 2, 'win_rate': 0.0}, 'Clay': {'wins': 0, 'matches': 0, 'win_rate': 0.0}, 'Grass': {'wins': 0, 'matches': 0, 'win_rate': 0.0}}",0,2024-08-12
Alec Beckley,0,1,1,0.0,641,"{'Hard': {'wins': 0, 'matches': 0, 'win_rate': 0.0}, 'Clay': {'wins': 0, 'matches': 1, 'win_rate': 0.0}, 'Grass': {'wins': 0, 'matches': 0, 'win_rate': 0.0}}",0,2024-09-14
Andres Andrade,2,1,3,0.6666666666666666,250,"{'Hard': {'wins': 1, 'matches': 2, 'win_rate': 0.5}, 'Clay': {'wins': 1, 'matches': 1, 'win_rate': 1.0}, 'Grass': {'wins': 0, 'matches': 0, 'win_rate': 0.0}}",2,2024-09-14
Oscar Otte,0,1,1,0.0,474,"{'Hard': {'wins': 0, 'matches': 0, 'win_rate': 0.0}, 'Clay': {'wins': 0, 'matches': 0, 'win_rate': 0.0}, 'Grass': {'wins': 0, 'matches': 1, 'win_rate': 0.0}}",0,2024-06-17
J J Wolf,2,9,11,0.18181818181818182,143,"{'Hard': {'wins': 1, 'matches': 7, 'win_rate': 0.14285714285714285}, 'Clay': {'wins': 1, 'matches': 4, 'win_rate': 0.25}, 'Grass': {'wins': 0, 'matches': 0, 'win_rate': 0.0}}",2,2024-07-29
Andrej Nedic,0,1,1,0.0,591,"{'Hard': {'wins': 0, 'matches': 1, 'win_rate': 0.0}, 'Clay': {'wins': 0, 'matches': 0, 'win_rate': 0.0}, 'Grass': {'wins': 0, 'matches': 0, 'win_rate': 0.0}}",0,2024-02-03
Filip Misolic,1,2,3,0.3333333333333333,228,"{'Hard': {'wins': 0, 'matches': 0, 'win_rate': 0.0}, 'Clay': {'wins': 1, 'matches': 3, 'win_rate': 0.3333333333333333}, 'Grass': {'wins': 0, 'matches': 0, 'win_rate': 0.0}}",1,2024-07-22
Pedro Martinez,18,23,41,0.43902439024390244,42,"{'Hard': {'wins': 4, 'matches': 15, 'win_rate': 0.26666666666666666}, 'Clay': {'wins': 14, 'matches': 23, 'win_rate': 0.6086956521739131}, 'Grass': {'wins': 0, 'matches': 3, 'win_rate': 0.0}}",2,2024-11-04
Rodrigo Crespo Piedra,0,1,1,0.0,999,"{'Hard': {'wins': 0, 'matches': 1, 'win_rate': 0.0}, 'Clay': {'wins': 0, 'matches': 0, 'win_rate': 0.0}, 'Grass': {'wins': 0, 'matches': 0, 'win_rate': 0.0}}",0,2024-02-02
Lucas Pouille,3,4,7,0.42857142857142855,212,"{'Hard': {'wins': 1, 'matches': 3, 'win_rate': 0.3333333333333333}, 'Clay': {'wins': 0, 'matches': 1, 'win_rate': 0.0}, 'Grass': {'wins': 2, 'matches': 3, 'win_rate': 0.6666666666666666}}",3,2024-07-01
Tomas Barrios Vera,2,5,7,0.2857142857142857,162,"{'Hard': {'wins': 0, 'matches': 1, 'win_rate': 0.0}, 'Clay': {'wins': 2, 'matches': 6, 'win_rate': 0.3333333333333333}, 'Grass': {'wins': 0, 'matches': 0, 'win_rate': 0.0}}",2,2024-09-12
Corentin Moutet,14,18,32,0.4375,66,"{'Hard': {'wins': 4, 'matches': 12, 'win_rate': 0.3333333333333333}, 'Clay': {'wins': 10, 'matches': 20, 'win_rate': 0.5}, 'Grass': {'wins': 0, 'matches': 0, 'win_rate': 0.0}}",4,2024-11-04
Juan Carlos Prado Angelo,1,0,1,1.0,605,"{'Hard': {'wins': 0, 'matches': 0, 'win_rate': 0.0}, 'Clay': {'wins': 1, 'matches': 1, 'win_rate': 1.0}, 'Grass': {'wins': 0, 'matches': 0, 'win_rate': 0.0}}",1,2024-02-03
Vasek Pospisil,1,1,2,0.5,610,"{'Hard': {'wins': 1, 'matches': 2, 'win_rate': 0.5}, 'Clay': {'wins': 0, 'matches': 0, 'win_rate': 0.0}, 'Grass': {'wins': 0, 'matches': 0, 'win_rate': 0.0}}",1,2024-08-05
Menelaos Efstathiou,0,1,1,0.0,1222,"{'Hard': {'wins': 0, 'matches': 1, 'win_rate': 0.0}, 'Clay': {'wins': 0, 'matches': 0, 'win_rate': 0.0}, 'Grass': {'wins': 0, 'matches': 0, 'win_rate': 0.0}}",0,2024-02-03
Luca Preda,0,1,1,0.0,1099,"{'Hard': {'wins': 0, 'matches': 1, 'win_rate': 0.0}, 'Clay': {'wins': 0, 'matches': 0, 'win_rate': 0.0}, 'Grass': {'wins': 0, 'matches': 0, 'win_rate': 0.0}}",0,2024-02-03
Alex De Minaur,48,22,70,0.6857142857142857,9,"{'Hard': {'wins': 30, 'matches': 45, 'win_rate': 0.6666666666666666}, 'Clay': {'wins': 10, 'matches': 15, 'win_rate': 0.6666666666666666}, 'Grass': {'wins': 8, 'matches': 10, 'win_rate': 0.8}}",4,2024-11-23
Niki Kaliyanda Poonacha,1,0,1,1.0,795,"{'Hard': {'wins': 0, 'matches': 0, 'win_rate': 0.0}, 'Clay': {'wins': 0, 'matches': 0, 'win_rate': 0.0}, 'Grass': {'wins': 1, 'matches': 1, 'win_rate': 1.0}}",1,2024-02-03
Marin Cilic,6,9,15,0.4,196,"{'Hard': {'wins': 6, 'matches': 14, 'win_rate': 0.42857142857142855}, 'Clay': {'wins': 0, 'matches': 1, 'win_rate': 0.0}, 'Grass': {'wins': 0, 'matches': 0, 'win_rate': 0.0}}",5,2024-11-04
Giovanni Mpetshi Perricard,17,12,29,0.5862068965517241,31,"{'Hard': {'wins': 8, 'matches': 16, 'win_rate': 0.5}, 'Clay': {'wins': 5, 'matches': 6, 'win_rate': 0.8333333333333334}, 'Grass': {'wins': 4, 'matches': 7, 'win_rate': 0.5714285714285714}}",6,2024-10-28
Martin Damm,2,1,3,0.6666666666666666,204,"{'Hard': {'wins': 2, 'matches': 3, 'win_rate': 0.6666666666666666}, 'Clay': {'wins': 0, 'matches': 0, 'win_rate': 0.0}, 'Grass': {'wins': 0, 'matches': 0, 'win_rate': 0.0}}",2,2024-03-18
David Goffin,17,16,33,0.5151515151515151,54,"{'Hard': {'wins': 15, 'matches': 25, 'win_rate': 0.6}, 'Clay': {'wins': 2, 'matches': 6, 'win_rate': 0.3333333333333333}, 'Grass': {'wins': 0, 'matches': 2, 'win_rate': 0.0}}",8,2024-10-21
Gael Monfils,25,22,47,0.5319148936170213,52,"{'Hard': {'wins': 17, 'matches': 31, 'win_rate': 0.5483870967741935}, 'Clay': {'wins': 3, 'matches': 9, 'win_rate': 0.3333333333333333}, 'Grass': {'wins': 5, 'matches': 7, 'win_rate': 0.7142857142857143}}",6,2024-10-21
Daniel Elahi Galan,7,16,23,0.30434782608695654,124,"{'Hard': {'wins': 2, 'matches': 6, 'win_rate': 0.3333333333333333}, 'Clay': {'wins': 5, 'matches': 16, 'win_rate': 0.3125}, 'Grass': {'wins': 0, 'matches': 1, 'win_rate': 0.0}}",3,2024-07-29
Nicolas Jarry,19,24,43,0.4418604651162791,37,"{'Hard': {'wins': 10, 'matches': 24, 'win_rate': 0.4166666666666667}, 'Clay': {'wins': 9, 'matches': 18, 'win_rate': 0.5}, 'Grass': {'wins': 0, 'matches': 1, 'win_rate': 0.0}}",3,2024-10-28
Justin Engel,1,1,2,0.5,458,"{'Hard': {'wins': 1, 'matches': 2, 'win_rate': 0.5}, 'Clay': {'wins': 0, 'matches': 0, 'win_rate': 0.0}, 'Grass': {'wins': 0, 'matches': 0, 'win_rate': 0.0}}",1,2024-10-14
Manuel Guinard,0,1,1,0.0,264,"{'Hard': {'wins': 0, 'matches': 1, 'win_rate': 0.0}, 'Clay': {'wins': 0, 'matches': 0, 'win_rate': 0.0}, 'Grass': {'wins': 0, 'matches': 0, 'win_rate': 0.0}}",0,2024-11-04
Matej Dodig,2,1,3,0.6666666666666666,291,"{'Hard': {'wins': 1, 'matches': 1, 'win_rate': 1.0}, 'Clay': {'wins': 1, 'matches': 2, 'win_rate': 0.5}, 'Grass': {'wins': 0, 'matches': 0, 'win_rate': 0.0}}",2,2024-09-13
Benjamin Lock,0,1,1,0.0,348,"{'Hard': {'wins': 0, 'matches': 1, 'win_rate': 0.0}, 'Clay': {'wins': 0, 'matches': 0, 'win_rate': 0.0}, 'Grass': {'wins': 0, 'matches': 0, 'win_rate': 0.0}}",0,2024-02-03
Raphael Collignon,0,3,3,0.0,164,"{'Hard': {'wins': 0, 'matches': 3, 'win_rate': 0.0}, 'Clay': {'wins': 0, 'matches': 0, 'win_rate': 0.0}, 'Grass': {'wins': 0, 'matches': 0, 'win_rate': 0.0}}",0,2024-10-14
Gonzalo Escobar,1,0,1,1.0,999,"{'Hard': {'wins': 1, 'matches': 1, 'win_rate': 1.0}, 'Clay': {'wins': 0, 'matches': 0, 'win_rate': 0.0}, 'Grass': {'wins': 0, 'matches': 0, 'win_rate': 0.0}}",1,2024-09-14
Duje Ajdukovic,5,6,11,0.45454545454545453,115,"{'Hard': {'wins': 2, 'matches': 4, 'win_rate': 0.5}, 'Clay': {'wins': 3, 'matches': 7, 'win_rate': 0.42857142857142855}, 'Grass': {'wins': 0, 'matches': 0, 'win_rate': 0.0}}",4,2024-11-04
Joel Schwaerzler,0,2,2,0.0,347,"{'Hard': {'wins': 0, 'matches': 1, 'win_rate': 0.0}, 'Clay': {'wins': 0, 'matches': 1, 'win_rate': 0.0}, 'Grass': {'wins': 0, 'matches': 0, 'win_rate': 0.0}}",0,2024-10-21
Kaipo Marshall,1,2,3,0.3333333333333333,999,"{'Hard': {'wins': 1, 'matches': 3, 'win_rate': 0.3333333333333333}, 'Clay': {'wins': 0, 'matches': 0, 'win_rate': 0.0}, 'Grass': {'wins': 0, 'matches': 0, 'win_rate': 0.0}}",1,2024-09-14
Daniel Rincon,0,1,1,0.0,216,"{'Hard': {'wins': 0, 'matches': 0, 'win_rate': 0.0}, 'Clay': {'wins': 0, 'matches': 1, 'win_rate': 0.0}, 'Grass': {'wins': 0, 'matches': 0, 'win_rate': 0.0}}",0,2024-04-15
Matteo Gigante,1,2,3,0.3333333333333333,139,"{'Hard': {'wins': 0, 'matches': 0, 'win_rate': 0.0}, 'Clay': {'wins': 1, 'matches': 3, 'win_rate': 0.3333333333333333}, 'Grass': {'wins': 0, 'matches': 0, 'win_rate': 0.0}}",1,2024-05-06
Linh Giang Trinh,0,2,2,0.0,999,"{'Hard': {'wins': 0, 'matches': 2, 'win_rate': 0.0}, 'Clay': {'wins': 0, 'matches': 0, 'win_rate': 0.0}, 'Grass': {'wins': 0, 'matches': 0, 'win_rate': 0.0}}",0,2024-02-02
Vit Kopriva,1,7,8,0.125,113,"{'Hard': {'wins': 1, 'matches': 4, 'win_rate': 0.25}, 'Clay': {'wins': 0, 'matches': 3, 'win_rate': 0.0}, 'Grass': {'wins': 0, 'matches': 1, 'win_rate': 0.0}}",1,2024-07-22
Dimitar Kuzmanov,0,1,1,0.0,225,"{'Hard': {'wins': 0, 'matches': 1, 'win_rate': 0.0}, 'Clay': {'wins': 0, 'matches': 0, 'win_rate': 0.0}, 'Grass': {'wins': 0, 'matches': 0, 'win_rate': 0.0}}",0,2024-02-03
Rodrigo Pacheco Mendez,2,3,5,0.4,444,"{'Hard': {'wins': 1, 'matches': 4, 'win_rate': 0.25}, 'Clay': {'wins': 1, 'matches': 1, 'win_rate': 1.0}, 'Grass': {'wins': 0, 'matches': 0, 'win_rate': 0.0}}",2,2024-09-14
Skander Mansouri,1,1,2,0.5,681,"{'Hard': {'wins': 0, 'matches': 0, 'win_rate': 0.0}, 'Clay': {'wins': 1, 'matches': 2, 'win_rate': 0.5}, 'Grass': {'wins': 0, 'matches': 0, 'win_rate': 0.0}}",1,2024-09-13
Liam Broady,1,4,5,0.2,156,"{'Hard': {'wins': 1, 'matches': 3, 'win_rate': 0.3333333333333333}, 'Clay': {'wins': 0, 'matches': 0, 'win_rate': 0.0}, 'Grass': {'wins': 0, 'matches': 2, 'win_rate': 0.0}}",1,2024-07-01
Hong Kit Jack Wong,1,0,1,1.0,1643,"{'Hard': {'wins': 1, 'matches': 1, 'win_rate': 1.0}, 'Clay': {'wins': 0, 'matches': 0, 'win_rate': 0.0}, 'Grass': {'wins': 0, 'matches': 0, 'win_rate': 0.0}}",1,2024-02-03
Gonzalo Bueno,0,1,1,0.0,273,"{'Hard': {'wins': 0, 'matches': 1, 'win_rate': 0.0}, 'Clay': {'wins': 0, 'matches': 0, 'win_rate': 0.0}, 'Grass': {'wins': 0, 'matches': 0, 'win_rate': 0.0}}",0,2024-09-13
Dino Prizmic,0,2,2,0.0,171,"{'Hard': {'wins': 0, 'matches': 2, 'win_rate': 0.0}, 'Clay': {'wins': 0, 'matches': 0, 'win_rate': 0.0}, 'Grass': {'wins': 0, 'matches': 0, 'win_rate': 0.0}}",0,2024-02-12
Aisam Ul Haq Qureshi,0,1,1,0.0,999,"{'Hard': {'wins': 0, 'matches': 0, 'win_rate': 0.0}, 'Clay': {'wins': 0, 'matches': 0, 'win_rate': 0.0}, 'Grass': {'wins': 0, 'matches': 1, 'win_rate': 0.0}}",0,2024-02-03
Alejandro Moro Canas,1,2,3,0.3333333333333333,188,"{'Hard': {'wins': 0, 'matches': 0, 'win_rate': 0.0}, 'Clay': {'wins': 1, 'matches': 2, 'win_rate': 0.5}, 'Grass': {'wins': 0, 'matches': 1, 'win_rate': 0.0}}",1,2024-07-01
Pierre Hugues Herbert,1,3,4,0.25,127,"{'Hard': {'wins': 1, 'matches': 2, 'win_rate': 0.5}, 'Clay': {'wins': 0, 'matches': 1, 'win_rate': 0.0}, 'Grass': {'wins': 0, 'matches': 1, 'win_rate': 0.0}}",1,2024-11-04
Learner Tien,6,4,10,0.6,122,"{'Hard': {'wins': 6, 'matches': 10, 'win_rate': 0.6}, 'Clay': {'wins': 0, 'matches': 0, 'win_rate': 0.0}, 'Grass': {'wins': 0, 'matches': 0, 'win_rate': 0.0}}",6,2024-12-18
Hubert Hurkacz,40,19,59,0.6779661016949152,14,"{'Hard': {'wins': 21, 'matches': 34, 'win_rate': 0.6176470588235294}, 'Clay': {'wins': 14, 'matches': 18, 'win_rate': 0.7777777777777778}, 'Grass': {'wins': 5, 'matches': 7, 'win_rate': 0.7142857142857143}}",5,2024-10-28
Roman Andres Burruchaga,1,3,4,0.25,144,"{'Hard': {'wins': 0, 'matches': 0, 'win_rate': 0.0}, 'Clay': {'wins': 1, 'matches': 4, 'win_rate': 0.25}, 'Grass': {'wins': 0, 'matches': 0, 'win_rate': 0.0}}",1,2024-05-27
Yasutaka Uchiyama,2,1,3,0.6666666666666666,160,"{'Hard': {'wins': 2, 'matches': 3, 'win_rate': 0.6666666666666666}, 'Clay': {'wins': 0, 'matches': 0, 'win_rate': 0.0}, 'Grass': {'wins': 0, 'matches': 0, 'win_rate': 0.0}}",2,2024-09-18
Denis Yevseyev,1,2,3,0.3333333333333333,207,"{'Hard': {'wins': 0, 'matches': 1, 'win_rate': 0.0}, 'Clay': {'wins': 1, 'matches': 2, 'win_rate': 0.5}, 'Grass': {'wins': 0, 'matches': 0, 'win_rate': 0.0}}",1,2024-09-18
Blaise Bicknell,2,0,2,1.0,319,"{'Hard': {'wins': 2, 'matches': 2, 'win_rate': 1.0}, 'Clay': {'wins': 0, 'matches': 0, 'win_rate': 0.0}, 'Grass': {'wins': 0, 'matches': 0, 'win_rate': 0.0}}",2,2024-02-03
